init_tom,resp_tom,init_lr,resp_lr,init_canLie,resp_canLie,init_initPoints,resp_initPoints,init_finalPoints,resp_finalPoints,init_gain,resp_gain,nr_offers,outcome_is_PE,is_best_sw_outcome,negotiation_success,passed_time
0,0,0.5,0.5,false,false,850,200,847,197,-3,-3,3,true,true,true,0.488
0,0,0.5,0.5,false,false,900,250,898,248,-2,-2,2,true,true,true,-1.0
0,0,0.5,0.5,false,false,350,300,398,798,48,498,2,true,true,true,-1.0
0,0,0.5,0.5,false,false,850,350,846,346,-4,-4,4,true,true,true,-1.0
0,0,0.5,0.5,false,false,850,250,847,247,-3,-3,3,true,true,true,-1.0
0,0,0.5,0.5,false,false,850,250,897,797,47,547,3,true,true,true,-1.0
0,0,0.5,0.5,false,false,200,250,197,247,-3,-3,3,true,true,true,-1.0
0,0,0.5,0.5,false,false,300,250,348,798,48,548,2,true,false,true,-1.0
0,0,0.5,0.5,false,false,200,250,196,246,-4,-4,4,true,true,true,-1.0
0,0,0.5,0.5,false,false,850,300,848,298,-2,-2,2,true,true,true,-1.0
0,0,0.5,0.5,false,false,300,250,297,247,-3,-3,3,true,true,true,-1.0
0,0,0.5,0.5,false,false,300,850,799,899,499,49,1,true,true,true,-1.0
0,0,0.5,0.5,false,false,300,300,346,796,46,496,4,true,true,true,-1.0
0,0,0.5,0.5,false,false,300,300,296,296,-4,-4,4,true,true,true,-1.0
0,0,0.5,0.5,false,false,300,900,296,896,-4,-4,4,true,true,true,-1.0
0,0,0.5,0.5,false,false,200,250,247,347,47,97,3,true,true,true,-1.0
0,0,0.5,0.5,false,false,300,250,348,798,48,548,2,true,false,true,-1.0
0,0,0.5,0.5,false,false,300,300,298,298,-2,-2,2,true,true,true,-1.0
0,0,0.5,0.5,false,false,350,250,346,246,-4,-4,4,true,true,true,-1.0
0,0,0.5,0.5,false,false,350,250,347,247,-3,-3,3,true,true,true,-1.0
0,1,0.5,0.5,false,false,300,200,799,249,499,49,1,true,true,true,0.657
0,1,0.5,0.5,false,false,850,200,846,196,-4,-4,4,true,true,true,-1.0
0,1,0.5,0.5,false,false,200,300,199,299,-1,-1,1,true,true,true,-1.0
0,1,0.5,0.5,false,false,300,250,796,346,496,96,4,true,true,true,-1.0
0,1,0.5,0.5,false,false,200,300,298,848,98,548,2,true,true,true,-1.0
0,1,0.5,0.5,false,false,300,200,296,196,-4,-4,4,true,true,true,-1.0
0,1,0.5,0.5,false,false,850,350,846,346,-4,-4,4,true,true,true,-1.0
0,1,0.5,0.5,false,false,900,250,948,798,48,548,2,true,true,true,-1.0
0,1,0.5,0.5,false,false,350,250,346,246,-4,-4,4,true,true,true,-1.0
0,1,0.5,0.5,false,false,200,850,196,846,-4,-4,4,true,true,true,-1.0
0,1,0.5,0.5,false,false,850,300,898,798,48,498,2,true,true,true,-1.0
0,1,0.5,0.5,false,false,900,200,898,198,-2,-2,2,true,true,true,-1.0
0,1,0.5,0.5,false,false,300,850,799,899,499,49,1,true,true,true,-1.0
0,1,0.5,0.5,false,false,300,250,799,299,499,49,1,true,true,true,-1.0
0,1,0.5,0.5,false,false,200,200,799,299,599,99,1,true,true,true,-1.0
0,1,0.5,0.5,false,false,250,250,298,848,48,598,2,true,true,true,-1.0
0,1,0.5,0.5,false,false,250,300,348,798,98,498,2,true,true,true,-1.0
0,1,0.5,0.5,false,false,250,300,298,798,48,498,2,true,true,true,-1.0
0,1,0.5,0.5,false,false,850,250,846,246,-4,-4,4,true,true,true,-1.0
0,1,0.5,0.5,false,false,300,900,297,897,-3,-3,3,true,true,true,-1.0
0,2,0.5,0.5,false,true,300,850,298,848,-2,-2,2,true,true,true,337.315
0,2,0.5,0.5,false,true,350,300,398,798,48,498,2,true,true,true,-1.0
0,2,0.5,0.5,false,true,250,350,249,349,-1,-1,1,true,true,true,-1.0
0,2,0.5,0.5,false,true,200,850,197,847,-3,-3,3,true,true,true,-1.0
0,2,0.5,0.5,false,true,900,250,896,246,-4,-4,4,true,true,true,-1.0
0,2,0.5,0.5,false,true,850,300,849,299,-1,-1,1,true,true,true,-1.0
0,2,0.5,0.5,false,true,850,300,846,296,-4,-4,4,true,true,true,-1.0
0,2,0.5,0.5,false,true,250,300,246,296,-4,-4,4,true,true,true,-1.0
0,2,0.5,0.5,false,true,850,850,849,849,-1,-1,1,true,true,true,-1.0
0,2,0.5,0.5,false,true,300,250,898,798,598,548,2,true,true,true,-1.0
0,2,0.5,0.5,false,true,300,200,296,196,-4,-4,4,false,false,false,-1.0
0,2,0.5,0.5,false,true,300,250,348,798,48,548,2,true,true,true,-1.0
0,2,0.5,0.5,false,true,350,200,899,249,549,49,1,true,true,true,-1.0
0,2,0.5,0.5,false,true,250,200,298,348,48,148,2,true,false,true,-1.0
0,2,0.5,0.5,false,true,300,250,797,347,497,97,3,true,true,true,-1.0
0,2,0.5,0.5,false,true,300,300,297,297,-3,-3,3,true,true,true,-1.0
0,2,0.5,0.5,false,true,200,250,398,798,198,548,2,true,true,true,-1.0
0,2,0.5,0.5,false,true,350,200,346,196,-4,-4,4,false,false,false,-1.0
0,2,0.5,0.5,false,true,350,350,346,346,-4,-4,4,true,true,true,-1.0
0,2,0.5,0.5,false,true,200,250,398,798,198,548,2,true,true,true,-1.0
0,2,0.5,0.5,false,false,250,850,249,849,-1,-1,1,true,true,true,65.716
0,2,0.5,0.5,false,false,250,250,799,899,549,649,1,true,true,true,-1.0
0,2,0.5,0.5,false,false,300,250,848,848,548,598,2,true,true,true,-1.0
0,2,0.5,0.5,false,false,350,250,398,798,48,548,2,true,true,true,-1.0
0,2,0.5,0.5,false,false,250,850,247,847,-3,-3,3,true,true,true,-1.0
0,2,0.5,0.5,false,false,300,850,297,847,-3,-3,3,true,true,true,-1.0
0,2,0.5,0.5,false,false,850,200,846,196,-4,-4,4,true,true,true,-1.0
0,2,0.5,0.5,false,false,250,200,298,798,48,598,2,true,true,true,-1.0
0,2,0.5,0.5,false,false,200,200,799,899,599,699,1,true,true,true,-1.0
0,2,0.5,0.5,false,false,350,350,346,346,-4,-4,4,true,true,true,-1.0
0,2,0.5,0.5,false,false,200,250,199,249,-1,-1,1,true,true,true,-1.0
0,2,0.5,0.5,false,false,850,250,897,797,47,547,3,true,true,true,-1.0
0,2,0.5,0.5,false,false,350,300,346,296,-4,-4,4,true,true,true,-1.0
0,2,0.5,0.5,false,false,850,300,848,298,-2,-2,2,true,true,true,-1.0
0,2,0.5,0.5,false,false,250,300,246,296,-4,-4,4,false,false,false,-1.0
0,2,0.5,0.5,false,false,200,300,799,349,599,49,1,true,true,true,-1.0
0,2,0.5,0.5,false,false,850,300,898,798,48,498,2,true,true,true,-1.0
0,2,0.5,0.5,false,false,250,200,246,196,-4,-4,4,true,true,true,-1.0
0,2,0.5,0.5,false,false,200,300,248,898,48,598,2,true,true,true,-1.0
0,2,0.5,0.5,false,false,250,250,298,798,48,548,2,true,true,true,-1.0
1,0,0.5,0.5,false,false,200,850,247,897,47,47,3,true,true,true,0.303
1,0,0.5,0.5,false,false,200,300,898,798,698,498,2,true,true,true,-1.0
1,0,0.5,0.5,false,false,300,300,300,300,0,0,0,false,false,false,-1.0
1,0,0.5,0.5,false,false,850,850,847,847,-3,-3,3,true,true,true,-1.0
1,0,0.5,0.5,false,false,850,200,898,798,48,598,2,true,true,true,-1.0
1,0,0.5,0.5,false,false,300,200,797,247,497,47,3,true,true,true,-1.0
1,0,0.5,0.5,false,false,250,300,247,297,-3,-3,3,true,true,true,-1.0
1,0,0.5,0.5,false,false,250,350,799,949,549,599,1,true,true,true,-1.0
1,0,0.5,0.5,false,false,200,200,197,197,-3,-3,3,true,true,true,-1.0
1,0,0.5,0.5,false,false,250,850,247,847,-3,-3,3,true,true,true,-1.0
1,0,0.5,0.5,false,false,850,850,847,847,-3,-3,3,true,true,true,-1.0
1,0,0.5,0.5,false,false,300,300,297,297,-3,-3,3,true,true,true,-1.0
1,0,0.5,0.5,false,false,300,200,347,247,47,47,3,true,true,true,-1.0
1,0,0.5,0.5,false,false,250,250,250,250,0,0,0,true,true,true,-1.0
1,0,0.5,0.5,false,false,850,250,850,250,0,0,0,true,true,true,-1.0
1,0,0.5,0.5,false,false,200,250,798,298,598,48,2,true,true,true,-1.0
1,0,0.5,0.5,false,false,250,200,848,898,598,698,2,true,true,true,-1.0
1,0,0.5,0.5,false,false,850,300,845,295,-5,-5,5,true,true,true,-1.0
1,0,0.5,0.5,false,false,250,300,250,300,0,0,0,true,true,true,-1.0
1,0,0.5,0.5,false,false,350,850,347,847,-3,-3,3,true,true,true,-1.0
1,1,0.5,0.5,false,false,250,350,200,300,-50,-50,50,true,true,true,1.241
1,1,0.5,0.5,false,false,850,350,800,300,-50,-50,50,true,true,true,-1.0
1,1,0.5,0.5,false,false,250,350,247,347,-3,-3,3,true,true,true,-1.0
1,1,0.5,0.5,false,false,300,250,797,397,497,147,3,true,true,true,-1.0
1,1,0.5,0.5,false,false,850,850,800,800,-50,-50,50,true,true,true,-1.0
1,1,0.5,0.5,false,false,300,250,796,796,496,546,4,true,true,true,-1.0
1,1,0.5,0.5,false,false,850,300,800,250,-50,-50,50,true,true,true,-1.0
1,1,0.5,0.5,false,false,250,250,797,397,547,147,3,true,true,true,-1.0
1,1,0.5,0.5,false,false,350,250,350,250,0,0,0,true,true,true,-1.0
1,1,0.5,0.5,false,false,300,250,250,200,-50,-50,50,true,true,true,-1.0
1,1,0.5,0.5,false,false,850,850,800,800,-50,-50,50,true,true,true,-1.0
1,1,0.5,0.5,false,false,300,200,250,150,-50,-50,50,true,true,true,-1.0
1,1,0.5,0.5,false,false,250,250,247,247,-3,-3,3,true,true,true,-1.0
1,1,0.5,0.5,false,false,300,350,250,300,-50,-50,50,true,true,true,-1.0
1,1,0.5,0.5,false,false,300,200,250,150,-50,-50,50,true,true,true,-1.0
1,1,0.5,0.5,false,false,850,250,899,799,49,549,1,true,true,true,-1.0
1,1,0.5,0.5,false,false,850,850,800,800,-50,-50,50,true,true,true,-1.0
1,1,0.5,0.5,false,false,850,300,848,298,-2,-2,2,true,true,true,-1.0
1,1,0.5,0.5,false,false,300,350,250,300,-50,-50,50,true,true,true,-1.0
1,1,0.5,0.5,false,false,250,200,799,299,549,99,1,true,true,true,-1.0
1,2,0.5,0.5,false,true,250,300,250,300,0,0,0,true,true,true,737.873
1,2,0.5,0.5,false,true,850,250,844,244,-6,-6,6,true,true,true,-1.0
1,2,0.5,0.5,false,true,250,250,246,246,-4,-4,4,true,true,true,-1.0
1,2,0.5,0.5,false,true,250,200,348,848,98,648,2,true,true,true,-1.0
1,2,0.5,0.5,false,true,250,300,298,898,48,598,2,true,true,true,-1.0
1,2,0.5,0.5,false,true,300,300,785,335,485,35,15,true,true,true,-1.0
1,2,0.5,0.5,false,true,300,300,294,294,-6,-6,6,true,true,true,-1.0
1,2,0.5,0.5,false,true,200,250,198,248,-2,-2,2,true,true,true,-1.0
1,2,0.5,0.5,false,true,300,250,250,200,-50,-50,50,false,false,false,-1.0
1,2,0.5,0.5,false,true,250,250,248,248,-2,-2,2,true,true,true,-1.0
1,2,0.5,0.5,false,true,850,200,899,299,49,99,1,true,true,true,-1.0
1,2,0.5,0.5,false,true,300,900,797,947,497,47,3,true,true,true,-1.0
1,2,0.5,0.5,false,true,300,200,298,198,-2,-2,2,true,true,true,-1.0
1,2,0.5,0.5,false,true,850,350,848,348,-2,-2,2,true,true,true,-1.0
1,2,0.5,0.5,false,true,300,250,298,248,-2,-2,2,true,true,true,-1.0
1,2,0.5,0.5,false,true,250,850,298,898,48,48,2,true,true,true,-1.0
1,2,0.5,0.5,false,true,250,300,250,300,0,0,0,true,true,true,-1.0
1,2,0.5,0.5,false,true,250,250,797,347,547,97,3,true,true,true,-1.0
1,2,0.5,0.5,false,true,300,850,797,897,497,47,3,true,true,true,-1.0
1,2,0.5,0.5,false,true,300,300,298,298,-2,-2,2,true,true,true,-1.0
1,2,0.5,0.5,false,false,250,850,248,848,-2,-2,2,true,true,true,178.655
1,2,0.5,0.5,false,false,850,300,897,797,47,497,3,true,true,true,-1.0
1,2,0.5,0.5,false,false,250,300,250,300,0,0,0,true,true,true,-1.0
1,2,0.5,0.5,false,false,200,300,197,297,-3,-3,3,true,true,true,-1.0
1,2,0.5,0.5,false,false,250,300,250,300,0,0,0,true,true,true,-1.0
1,2,0.5,0.5,false,false,250,300,298,348,48,48,2,true,true,true,-1.0
1,2,0.5,0.5,false,false,850,200,850,200,0,0,0,true,true,true,-1.0
1,2,0.5,0.5,false,false,350,300,346,296,-4,-4,4,true,true,true,-1.0
1,2,0.5,0.5,false,false,850,250,850,250,0,0,0,true,true,true,-1.0
1,2,0.5,0.5,false,false,200,250,249,399,49,149,1,true,true,true,-1.0
1,2,0.5,0.5,false,false,250,350,298,898,48,548,2,true,true,true,-1.0
1,2,0.5,0.5,false,false,200,300,248,348,48,48,2,true,true,true,-1.0
1,2,0.5,0.5,false,false,350,250,348,248,-2,-2,2,true,true,true,-1.0
1,2,0.5,0.5,false,false,300,200,300,200,0,0,0,false,false,false,-1.0
1,2,0.5,0.5,false,false,200,900,298,948,98,48,2,true,true,true,-1.0
1,2,0.5,0.5,false,false,250,250,298,298,48,48,2,true,true,true,-1.0
1,2,0.5,0.5,false,false,300,200,300,200,0,0,0,true,true,true,-1.0
1,2,0.5,0.5,false,false,850,900,849,899,-1,-1,1,true,true,true,-1.0
1,2,0.5,0.5,false,false,200,250,198,248,-2,-2,2,true,true,true,-1.0
1,2,0.5,0.5,false,false,300,300,298,298,-2,-2,2,true,true,true,-1.0
2,0,0.5,0.5,true,false,850,900,850,900,0,0,0,true,true,true,594.204
2,0,0.5,0.5,true,false,350,300,399,799,49,499,1,true,true,true,-1.0
2,0,0.5,0.5,true,false,300,300,297,297,-3,-3,3,false,false,false,-1.0
2,0,0.5,0.5,true,false,350,250,949,799,599,549,1,true,true,true,-1.0
2,0,0.5,0.5,true,false,250,250,298,798,48,548,2,true,true,true,-1.0
2,0,0.5,0.5,true,false,250,250,348,798,98,548,2,true,true,true,-1.0
2,0,0.5,0.5,true,false,350,350,350,350,0,0,0,true,true,true,-1.0
2,0,0.5,0.5,true,false,300,250,298,248,-2,-2,2,true,true,true,-1.0
2,0,0.5,0.5,true,false,300,250,300,250,0,0,0,true,true,true,-1.0
2,0,0.5,0.5,true,false,300,300,298,298,-2,-2,2,true,true,true,-1.0
2,0,0.5,0.5,true,false,250,250,347,297,97,47,3,true,false,true,-1.0
2,0,0.5,0.5,true,false,200,250,348,798,148,548,2,true,true,true,-1.0
2,0,0.5,0.5,true,false,850,200,899,299,49,99,1,true,true,true,-1.0
2,0,0.5,0.5,true,false,300,250,295,245,-5,-5,5,true,true,true,-1.0
2,0,0.5,0.5,true,false,300,300,296,296,-4,-4,4,true,true,true,-1.0
2,0,0.5,0.5,true,false,200,900,197,897,-3,-3,3,true,true,true,-1.0
2,0,0.5,0.5,true,false,250,300,247,297,-3,-3,3,false,false,false,-1.0
2,0,0.5,0.5,true,false,850,250,847,247,-3,-3,3,true,true,true,-1.0
2,0,0.5,0.5,true,false,250,250,799,899,549,649,1,true,true,true,-1.0
2,0,0.5,0.5,true,false,250,250,250,250,0,0,0,true,true,true,-1.0
2,0,0.5,0.5,false,false,850,200,845,195,-5,-5,5,true,true,true,113.37
2,0,0.5,0.5,false,false,900,350,895,345,-5,-5,5,true,true,true,-1.0
2,0,0.5,0.5,false,false,250,250,898,798,648,548,2,true,true,true,-1.0
2,0,0.5,0.5,false,false,250,200,797,297,547,97,3,true,true,true,-1.0
2,0,0.5,0.5,false,false,200,300,195,295,-5,-5,5,false,false,false,-1.0
2,0,0.5,0.5,false,false,850,300,899,799,49,499,1,true,true,true,-1.0
2,0,0.5,0.5,false,false,850,200,847,197,-3,-3,3,true,true,true,-1.0
2,0,0.5,0.5,false,false,300,250,898,798,598,548,2,true,true,true,-1.0
2,0,0.5,0.5,false,false,250,850,247,847,-3,-3,3,true,true,true,-1.0
2,0,0.5,0.5,false,false,850,250,845,245,-5,-5,5,true,true,true,-1.0
2,0,0.5,0.5,false,false,200,300,200,300,0,0,0,true,true,true,-1.0
2,0,0.5,0.5,false,false,300,350,297,347,-3,-3,3,true,true,true,-1.0
2,0,0.5,0.5,false,false,300,300,849,899,549,599,1,true,true,true,-1.0
2,0,0.5,0.5,false,false,250,300,247,297,-3,-3,3,true,true,true,-1.0
2,0,0.5,0.5,false,false,900,200,947,247,47,47,3,true,true,true,-1.0
2,0,0.5,0.5,false,false,300,300,348,798,48,498,2,true,true,true,-1.0
2,0,0.5,0.5,false,false,250,200,247,197,-3,-3,3,false,false,false,-1.0
2,0,0.5,0.5,false,false,200,850,195,845,-5,-5,5,true,true,true,-1.0
2,0,0.5,0.5,false,false,300,250,295,245,-5,-5,5,true,true,true,-1.0
2,0,0.5,0.5,false,false,250,200,797,247,547,47,3,true,false,true,-1.0
2,1,0.5,0.5,true,false,300,900,297,897,-3,-3,3,true,true,true,794.329
2,1,0.5,0.5,true,false,200,300,177,277,-23,-23,23,true,true,true,-1.0
2,1,0.5,0.5,true,false,250,300,250,300,0,0,0,true,true,true,-1.0
2,1,0.5,0.5,true,false,250,350,247,347,-3,-3,3,true,true,true,-1.0
2,1,0.5,0.5,true,false,300,200,347,247,47,47,3,true,true,true,-1.0
2,1,0.5,0.5,true,false,350,200,350,200,0,0,0,true,true,true,-1.0
2,1,0.5,0.5,true,false,350,300,899,349,549,49,1,true,true,true,-1.0
2,1,0.5,0.5,true,false,300,250,798,298,498,48,2,true,true,true,-1.0
2,1,0.5,0.5,true,false,350,350,347,347,-3,-3,3,true,true,true,-1.0
2,1,0.5,0.5,true,false,300,300,295,295,-5,-5,5,false,false,false,-1.0
2,1,0.5,0.5,true,false,250,350,247,347,-3,-3,3,true,true,true,-1.0
2,1,0.5,0.5,true,false,300,300,295,295,-5,-5,5,true,true,true,-1.0
2,1,0.5,0.5,true,false,850,250,850,250,0,0,0,true,true,true,-1.0
2,1,0.5,0.5,true,false,300,200,300,200,0,0,0,true,true,true,-1.0
2,1,0.5,0.5,true,false,300,200,797,247,497,47,3,true,true,true,-1.0
2,1,0.5,0.5,true,false,300,300,250,250,-50,-50,50,false,false,false,-1.0
2,1,0.5,0.5,true,false,200,300,798,898,598,598,2,true,true,true,-1.0
2,1,0.5,0.5,true,false,250,250,247,247,-3,-3,3,false,false,false,-1.0
2,1,0.5,0.5,true,false,350,300,347,297,-3,-3,3,true,true,true,-1.0
2,1,0.5,0.5,true,false,850,300,847,297,-3,-3,3,true,true,true,-1.0
2,1,0.5,0.5,false,false,200,300,248,798,48,498,2,true,true,true,133.985
2,1,0.5,0.5,false,false,850,850,850,850,0,0,0,true,true,true,-1.0
2,1,0.5,0.5,false,false,250,300,798,348,548,48,2,true,true,true,-1.0
2,1,0.5,0.5,false,false,350,200,398,298,48,98,2,true,true,true,-1.0
2,1,0.5,0.5,false,false,350,300,347,297,-3,-3,3,true,true,true,-1.0
2,1,0.5,0.5,false,false,300,850,297,847,-3,-3,3,true,true,true,-1.0
2,1,0.5,0.5,false,false,350,850,350,850,0,0,0,true,true,true,-1.0
2,1,0.5,0.5,false,false,250,850,247,847,-3,-3,3,true,true,true,-1.0
2,1,0.5,0.5,false,false,850,250,850,250,0,0,0,true,true,true,-1.0
2,1,0.5,0.5,false,false,850,300,847,297,-3,-3,3,true,true,true,-1.0
2,1,0.5,0.5,false,false,200,300,187,287,-13,-13,13,true,true,true,-1.0
2,1,0.5,0.5,false,false,300,300,297,297,-3,-3,3,true,true,true,-1.0
2,1,0.5,0.5,false,false,250,250,299,799,49,549,1,true,true,true,-1.0
2,1,0.5,0.5,false,false,300,850,297,847,-3,-3,3,true,true,true,-1.0
2,1,0.5,0.5,false,false,350,300,343,293,-7,-7,7,true,true,true,-1.0
2,1,0.5,0.5,false,false,300,300,250,250,-50,-50,50,false,false,false,-1.0
2,1,0.5,0.5,false,false,850,350,849,349,-1,-1,1,true,true,true,-1.0
2,1,0.5,0.5,false,false,250,350,348,898,98,548,2,true,true,true,-1.0
2,1,0.5,0.5,false,false,300,300,798,348,498,48,2,true,true,true,-1.0
2,1,0.5,0.5,false,false,850,300,899,799,49,499,1,true,true,true,-1.0
2,2,0.5,0.5,true,true,250,300,248,298,-2,-2,2,true,true,true,535.56
2,2,0.5,0.5,true,true,250,900,249,899,-1,-1,1,true,true,true,-1.0
2,2,0.5,0.5,true,true,250,200,248,198,-2,-2,2,false,false,false,-1.0
2,2,0.5,0.5,true,true,200,300,199,299,-1,-1,1,true,true,true,-1.0
2,2,0.5,0.5,true,true,300,350,298,348,-2,-2,2,true,true,true,-1.0
2,2,0.5,0.5,true,true,900,250,899,249,-1,-1,1,true,true,true,-1.0
2,2,0.5,0.5,true,true,250,300,798,348,548,48,2,true,true,true,-1.0
2,2,0.5,0.5,true,true,850,850,849,849,-1,-1,1,true,true,true,-1.0
2,2,0.5,0.5,true,true,350,900,349,899,-1,-1,1,true,true,true,-1.0
2,2,0.5,0.5,true,true,300,300,299,299,-1,-1,1,true,true,true,-1.0
2,2,0.5,0.5,true,true,300,250,896,796,596,546,4,true,true,true,-1.0
2,2,0.5,0.5,true,true,300,250,349,299,49,49,1,true,true,true,-1.0
2,2,0.5,0.5,true,true,250,250,798,898,548,648,2,true,true,true,-1.0
2,2,0.5,0.5,true,true,850,200,899,249,49,49,1,true,true,true,-1.0
2,2,0.5,0.5,true,true,300,250,299,249,-1,-1,1,true,true,true,-1.0
2,2,0.5,0.5,true,true,200,300,198,298,-2,-2,2,true,true,true,-1.0
2,2,0.5,0.5,true,true,300,300,299,299,-1,-1,1,true,true,true,-1.0
2,2,0.5,0.5,true,true,350,850,349,849,-1,-1,1,true,true,true,-1.0
2,2,0.5,0.5,true,true,250,300,249,299,-1,-1,1,true,true,true,-1.0
2,2,0.5,0.5,true,true,200,350,198,348,-2,-2,2,true,true,true,-1.0
2,2,0.5,0.5,true,false,250,300,248,298,-2,-2,2,true,true,true,384.967
2,2,0.5,0.5,true,false,300,200,300,200,0,0,0,true,true,true,-1.0
2,2,0.5,0.5,true,false,250,850,799,899,549,49,1,true,true,true,-1.0
2,2,0.5,0.5,true,false,250,850,250,850,0,0,0,true,true,true,-1.0
2,2,0.5,0.5,true,false,900,300,899,299,-1,-1,1,true,true,true,-1.0
2,2,0.5,0.5,true,false,200,200,198,198,-2,-2,2,true,true,true,-1.0
2,2,0.5,0.5,true,false,200,300,198,298,-2,-2,2,true,true,true,-1.0
2,2,0.5,0.5,true,false,200,300,198,298,-2,-2,2,true,true,true,-1.0
2,2,0.5,0.5,true,false,300,300,298,298,-2,-2,2,true,true,true,-1.0
2,2,0.5,0.5,true,false,850,300,847,297,-3,-3,3,true,true,true,-1.0
2,2,0.5,0.5,true,false,200,200,199,199,-1,-1,1,true,true,true,-1.0
2,2,0.5,0.5,true,false,300,300,299,299,-1,-1,1,true,true,true,-1.0
2,2,0.5,0.5,true,false,850,850,850,850,0,0,0,true,true,true,-1.0
2,2,0.5,0.5,true,false,300,250,797,297,497,47,3,true,true,true,-1.0
2,2,0.5,0.5,true,false,250,300,848,898,598,598,2,true,true,true,-1.0
2,2,0.5,0.5,true,false,250,300,299,799,49,499,1,true,true,true,-1.0
2,2,0.5,0.5,true,false,850,250,850,250,0,0,0,true,true,true,-1.0
2,2,0.5,0.5,true,false,300,200,250,150,-50,-50,50,false,false,false,-1.0
2,2,0.5,0.5,true,false,350,250,899,299,549,49,1,true,true,true,-1.0
2,2,0.5,0.5,true,false,200,250,197,247,-3,-3,3,true,true,true,-1.0
2,2,0.5,0.5,false,true,900,300,949,799,49,499,1,true,true,true,366.275
2,2,0.5,0.5,false,true,300,300,798,898,498,598,2,true,true,true,-1.0
2,2,0.5,0.5,false,true,200,200,198,198,-2,-2,2,true,true,true,-1.0
2,2,0.5,0.5,false,true,350,200,899,299,549,99,1,true,true,true,-1.0
2,2,0.5,0.5,false,true,200,200,200,200,0,0,0,true,true,true,-1.0
2,2,0.5,0.5,false,true,300,250,797,297,497,47,3,true,true,true,-1.0
2,2,0.5,0.5,false,true,250,350,798,398,548,48,2,true,true,true,-1.0
2,2,0.5,0.5,false,true,250,300,249,299,-1,-1,1,true,true,true,-1.0
2,2,0.5,0.5,false,true,300,300,348,798,48,498,2,true,true,true,-1.0
2,2,0.5,0.5,false,true,300,200,798,348,498,148,2,true,true,true,-1.0
2,2,0.5,0.5,false,true,200,300,199,299,-1,-1,1,true,true,true,-1.0
2,2,0.5,0.5,false,true,850,250,849,249,-1,-1,1,true,true,true,-1.0
2,2,0.5,0.5,false,true,300,300,348,798,48,498,2,true,true,true,-1.0
2,2,0.5,0.5,false,true,200,350,897,897,697,547,3,true,true,true,-1.0
2,2,0.5,0.5,false,true,200,250,199,249,-1,-1,1,true,true,true,-1.0
2,2,0.5,0.5,false,true,250,300,249,299,-1,-1,1,true,true,true,-1.0
2,2,0.5,0.5,false,true,850,200,899,299,49,99,1,true,true,true,-1.0
2,2,0.5,0.5,false,true,850,300,849,299,-1,-1,1,true,true,true,-1.0
2,2,0.5,0.5,false,true,300,850,299,849,-1,-1,1,true,true,true,-1.0
2,2,0.5,0.5,false,true,850,900,849,899,-1,-1,1,true,true,true,-1.0
2,2,0.5,0.5,false,false,350,300,350,300,0,0,0,true,true,true,83.083
2,2,0.5,0.5,false,false,200,900,199,899,-1,-1,1,true,true,true,-1.0
2,2,0.5,0.5,false,false,300,300,297,297,-3,-3,3,true,true,true,-1.0
2,2,0.5,0.5,false,false,200,850,199,849,-1,-1,1,true,true,true,-1.0
2,2,0.5,0.5,false,false,250,350,799,949,549,599,1,true,true,true,-1.0
2,2,0.5,0.5,false,false,300,300,299,299,-1,-1,1,true,true,true,-1.0
2,2,0.5,0.5,false,false,250,200,250,200,0,0,0,true,true,true,-1.0
2,2,0.5,0.5,false,false,200,350,799,949,599,599,1,true,true,true,-1.0
2,2,0.5,0.5,false,false,300,200,799,249,499,49,1,true,true,true,-1.0
2,2,0.5,0.5,false,false,850,250,850,250,0,0,0,true,true,true,-1.0
2,2,0.5,0.5,false,false,300,350,299,349,-1,-1,1,true,true,true,-1.0
2,2,0.5,0.5,false,false,300,850,299,849,-1,-1,1,true,true,true,-1.0
2,2,0.5,0.5,false,false,300,350,899,899,599,549,1,true,true,true,-1.0
2,2,0.5,0.5,false,false,250,250,249,249,-1,-1,1,true,true,true,-1.0
2,2,0.5,0.5,false,false,250,300,298,898,48,598,2,true,true,true,-1.0
2,2,0.5,0.5,false,false,300,250,300,250,0,0,0,true,true,true,-1.0
2,2,0.5,0.5,false,false,300,850,299,849,-1,-1,1,true,true,true,-1.0
2,2,0.5,0.5,false,false,300,850,300,850,0,0,0,true,true,true,-1.0
2,2,0.5,0.5,false,false,200,250,398,798,198,548,2,true,true,true,-1.0
2,2,0.5,0.5,false,false,300,350,298,348,-2,-2,2,true,true,true,-1.0
0,0,0.5,0.5,false,false,300,200,799,899,499,699,1,true,true,true,0.194
0,0,0.5,0.5,false,false,850,250,848,248,-2,-2,2,true,true,true,-1.0
0,0,0.5,0.5,false,false,300,850,297,847,-3,-3,3,true,true,true,-1.0
0,0,0.5,0.5,false,false,250,300,799,899,549,599,1,true,true,true,-1.0
0,0,0.5,0.5,false,false,300,200,347,247,47,47,3,true,true,true,-1.0
0,0,0.5,0.5,false,false,250,200,897,247,647,47,3,true,true,true,-1.0
0,0,0.5,0.5,false,false,200,300,196,296,-4,-4,4,true,true,true,-1.0
0,0,0.5,0.5,false,false,250,300,799,799,549,499,1,true,true,true,-1.0
0,0,0.5,0.5,false,false,300,200,799,299,499,99,1,true,true,true,-1.0
0,0,0.5,0.5,false,false,850,850,847,847,-3,-3,3,true,true,true,-1.0
0,0,0.5,0.5,false,false,900,250,898,248,-2,-2,2,false,false,false,-1.0
0,0,0.5,0.5,false,false,250,250,246,246,-4,-4,4,true,true,true,-1.0
0,0,0.5,0.5,false,false,250,250,247,247,-3,-3,3,true,true,true,-1.0
0,0,0.5,0.5,false,false,200,250,197,247,-3,-3,3,true,true,true,-1.0
0,0,0.5,0.5,false,false,200,200,198,198,-2,-2,2,true,true,true,-1.0
0,0,0.5,0.5,false,false,300,250,296,246,-4,-4,4,true,true,true,-1.0
0,0,0.5,0.5,false,false,250,250,797,347,547,97,3,true,true,true,-1.0
0,0,0.5,0.5,false,false,200,200,196,196,-4,-4,4,true,true,true,-1.0
0,0,0.5,0.5,false,false,200,200,197,197,-3,-3,3,true,true,true,-1.0
0,0,0.5,0.5,false,false,250,350,246,346,-4,-4,4,true,true,true,-1.0
0,1,0.5,0.5,false,false,250,250,246,246,-4,-4,4,true,true,true,0.256
0,1,0.5,0.5,false,false,250,200,799,249,549,49,1,true,true,true,-1.0
0,1,0.5,0.5,false,false,300,300,348,798,48,498,2,true,true,true,-1.0
0,1,0.5,0.5,false,false,850,850,848,848,-2,-2,2,true,true,true,-1.0
0,1,0.5,0.5,false,false,200,250,398,798,198,548,2,true,true,true,-1.0
0,1,0.5,0.5,false,false,300,350,297,347,-3,-3,3,true,true,true,-1.0
0,1,0.5,0.5,false,false,250,350,799,949,549,599,1,true,true,true,-1.0
0,1,0.5,0.5,false,false,850,350,848,348,-2,-2,2,true,true,true,-1.0
0,1,0.5,0.5,false,false,850,300,898,798,48,498,2,true,true,true,-1.0
0,1,0.5,0.5,false,false,200,300,799,349,599,49,1,true,true,true,-1.0
0,1,0.5,0.5,false,false,350,300,398,798,48,498,2,true,true,true,-1.0
0,1,0.5,0.5,false,false,200,300,248,398,48,98,2,true,true,true,-1.0
0,1,0.5,0.5,false,false,300,200,898,898,598,698,2,true,true,true,-1.0
0,1,0.5,0.5,false,false,300,350,297,347,-3,-3,3,true,true,true,-1.0
0,1,0.5,0.5,false,false,200,300,248,348,48,48,2,true,true,true,-1.0
0,1,0.5,0.5,false,false,850,350,846,346,-4,-4,4,true,true,true,-1.0
0,1,0.5,0.5,false,false,850,300,846,296,-4,-4,4,true,true,true,-1.0
0,1,0.5,0.5,false,false,350,350,348,348,-2,-2,2,true,true,true,-1.0
0,1,0.5,0.5,false,false,300,200,348,798,48,598,2,true,true,true,-1.0
0,1,0.5,0.5,false,false,200,300,248,348,48,48,2,true,false,true,-1.0
0,2,0.5,0.5,false,true,200,850,199,849,-1,-1,1,true,true,true,386.012
0,2,0.5,0.5,false,true,300,250,298,248,-2,-2,2,true,true,true,-1.0
0,2,0.5,0.5,false,true,300,300,297,297,-3,-3,3,true,true,true,-1.0
0,2,0.5,0.5,false,true,300,200,296,196,-4,-4,4,false,false,false,-1.0
0,2,0.5,0.5,false,true,250,850,249,849,-1,-1,1,true,true,true,-1.0
0,2,0.5,0.5,false,true,250,200,246,196,-4,-4,4,true,true,true,-1.0
0,2,0.5,0.5,false,true,250,850,249,849,-1,-1,1,true,true,true,-1.0
0,2,0.5,0.5,false,true,300,250,297,247,-3,-3,3,true,true,true,-1.0
0,2,0.5,0.5,false,true,300,300,299,299,-1,-1,1,true,true,true,-1.0
0,2,0.5,0.5,false,true,250,300,296,796,46,496,4,true,true,true,-1.0
0,2,0.5,0.5,false,true,850,350,849,349,-1,-1,1,true,true,true,-1.0
0,2,0.5,0.5,false,true,350,250,398,798,48,548,2,true,true,true,-1.0
0,2,0.5,0.5,false,true,200,300,196,296,-4,-4,4,true,true,true,-1.0
0,2,0.5,0.5,false,true,900,250,896,246,-4,-4,4,true,true,true,-1.0
0,2,0.5,0.5,false,true,300,300,297,297,-3,-3,3,true,true,true,-1.0
0,2,0.5,0.5,false,true,200,300,248,798,48,498,2,true,true,true,-1.0
0,2,0.5,0.5,false,true,250,200,348,798,98,598,2,true,true,true,-1.0
0,2,0.5,0.5,false,true,200,200,199,199,-1,-1,1,true,true,true,-1.0
0,2,0.5,0.5,false,true,200,850,199,849,-1,-1,1,true,true,true,-1.0
0,2,0.5,0.5,false,true,200,200,196,196,-4,-4,4,false,false,false,-1.0
0,2,0.5,0.5,false,false,200,200,199,199,-1,-1,1,true,true,true,66.665
0,2,0.5,0.5,false,false,350,200,349,199,-1,-1,1,true,true,true,-1.0
0,2,0.5,0.5,false,false,350,300,346,296,-4,-4,4,true,true,true,-1.0
0,2,0.5,0.5,false,false,300,300,296,296,-4,-4,4,true,true,true,-1.0
0,2,0.5,0.5,false,false,300,200,799,249,499,49,1,true,false,true,-1.0
0,2,0.5,0.5,false,false,850,300,848,298,-2,-2,2,true,true,true,-1.0
0,2,0.5,0.5,false,false,250,250,298,798,48,548,2,true,true,true,-1.0
0,2,0.5,0.5,false,false,250,300,799,399,549,99,1,true,true,true,-1.0
0,2,0.5,0.5,false,false,200,850,199,849,-1,-1,1,true,true,true,-1.0
0,2,0.5,0.5,false,false,300,850,799,899,499,49,1,true,true,true,-1.0
0,2,0.5,0.5,false,false,300,850,299,849,-1,-1,1,true,true,true,-1.0
0,2,0.5,0.5,false,false,900,200,896,196,-4,-4,4,true,true,true,-1.0
0,2,0.5,0.5,false,false,250,850,249,849,-1,-1,1,true,true,true,-1.0
0,2,0.5,0.5,false,false,250,200,296,296,46,96,4,true,false,true,-1.0
0,2,0.5,0.5,false,false,850,900,849,899,-1,-1,1,true,true,true,-1.0
0,2,0.5,0.5,false,false,300,300,296,296,-4,-4,4,true,true,true,-1.0
0,2,0.5,0.5,false,false,850,850,849,849,-1,-1,1,true,true,true,-1.0
0,2,0.5,0.5,false,false,250,200,799,299,549,99,1,true,true,true,-1.0
0,2,0.5,0.5,false,false,250,250,246,246,-4,-4,4,true,true,true,-1.0
0,2,0.5,0.5,false,false,200,250,246,296,46,46,4,true,false,true,-1.0
1,0,0.5,0.5,false,false,200,300,248,798,48,498,2,true,true,true,0.272
1,0,0.5,0.5,false,false,300,250,799,899,499,649,1,true,true,true,-1.0
1,0,0.5,0.5,false,false,850,200,850,200,0,0,0,true,true,true,-1.0
1,0,0.5,0.5,false,false,300,300,297,297,-3,-3,3,true,true,true,-1.0
1,0,0.5,0.5,false,false,350,300,399,799,49,499,1,true,true,true,-1.0
1,0,0.5,0.5,false,false,300,200,799,899,499,699,1,true,true,true,-1.0
1,0,0.5,0.5,false,false,300,300,949,799,649,499,1,true,true,true,-1.0
1,0,0.5,0.5,false,false,850,200,845,195,-5,-5,5,true,true,true,-1.0
1,0,0.5,0.5,false,false,300,300,295,295,-5,-5,5,false,false,false,-1.0
1,0,0.5,0.5,false,false,300,250,295,245,-5,-5,5,true,true,true,-1.0
1,0,0.5,0.5,false,false,200,900,197,897,-3,-3,3,true,true,true,-1.0
1,0,0.5,0.5,false,false,850,300,850,300,0,0,0,true,true,true,-1.0
1,0,0.5,0.5,false,false,250,300,799,899,549,599,1,true,true,true,-1.0
1,0,0.5,0.5,false,false,850,250,850,250,0,0,0,true,true,true,-1.0
1,0,0.5,0.5,false,false,200,350,197,347,-3,-3,3,true,true,true,-1.0
1,0,0.5,0.5,false,false,350,250,350,250,0,0,0,true,true,true,-1.0
1,0,0.5,0.5,false,false,300,300,348,798,48,498,2,true,true,true,-1.0
1,0,0.5,0.5,false,false,250,300,247,797,-3,497,3,true,true,true,-1.0
1,0,0.5,0.5,false,false,300,250,799,299,499,49,1,true,true,true,-1.0
1,0,0.5,0.5,false,false,250,200,947,247,697,47,3,true,true,true,-1.0
1,1,0.5,0.5,false,false,300,300,797,347,497,47,3,true,true,true,1.054
1,1,0.5,0.5,false,false,200,850,150,800,-50,-50,50,false,false,false,-1.0
1,1,0.5,0.5,false,false,850,300,850,300,0,0,0,true,true,true,-1.0
1,1,0.5,0.5,false,false,300,200,300,200,0,0,0,true,true,true,-1.0
1,1,0.5,0.5,false,false,250,250,246,246,-4,-4,4,true,true,true,-1.0
1,1,0.5,0.5,false,false,850,300,850,300,0,0,0,true,true,true,-1.0
1,1,0.5,0.5,false,false,300,300,948,798,648,498,2,true,true,true,-1.0
1,1,0.5,0.5,false,false,300,350,348,898,48,548,2,true,true,true,-1.0
1,1,0.5,0.5,false,false,350,350,347,347,-3,-3,3,true,true,true,-1.0
1,1,0.5,0.5,false,false,300,200,300,200,0,0,0,true,true,true,-1.0
1,1,0.5,0.5,false,false,300,250,297,247,-3,-3,3,true,true,true,-1.0
1,1,0.5,0.5,false,false,200,200,249,799,49,599,1,true,true,true,-1.0
1,1,0.5,0.5,false,false,250,300,200,250,-50,-50,50,true,true,true,-1.0
1,1,0.5,0.5,false,false,350,850,300,800,-50,-50,50,true,true,true,-1.0
1,1,0.5,0.5,false,false,300,850,799,899,499,49,1,true,true,true,-1.0
1,1,0.5,0.5,false,false,300,350,300,350,0,0,0,true,true,true,-1.0
1,1,0.5,0.5,false,false,250,300,200,250,-50,-50,50,false,false,false,-1.0
1,1,0.5,0.5,false,false,300,250,797,297,497,47,3,true,true,true,-1.0
1,1,0.5,0.5,false,false,300,300,797,347,497,47,3,true,true,true,-1.0
1,1,0.5,0.5,false,false,200,300,150,250,-50,-50,50,false,false,false,-1.0
1,2,0.5,0.5,false,true,300,300,250,250,-50,-50,50,true,true,true,873.452
1,2,0.5,0.5,false,true,200,250,298,848,98,598,2,true,true,true,-1.0
1,2,0.5,0.5,false,true,250,850,249,849,-1,-1,1,true,true,true,-1.0
1,2,0.5,0.5,false,true,300,200,300,200,0,0,0,true,true,true,-1.0
1,2,0.5,0.5,false,true,250,300,250,300,0,0,0,true,true,true,-1.0
1,2,0.5,0.5,false,true,250,300,797,347,547,47,3,true,true,true,-1.0
1,2,0.5,0.5,false,true,200,250,797,897,597,647,3,true,true,true,-1.0
1,2,0.5,0.5,false,true,300,250,300,250,0,0,0,true,true,true,-1.0
1,2,0.5,0.5,false,true,200,850,199,849,-1,-1,1,true,true,true,-1.0
1,2,0.5,0.5,false,true,300,200,325,225,25,25,25,true,true,true,-1.0
1,2,0.5,0.5,false,true,250,300,248,298,-2,-2,2,true,true,true,-1.0
1,2,0.5,0.5,false,true,250,300,248,298,-2,-2,2,true,true,true,-1.0
1,2,0.5,0.5,false,true,300,850,300,850,0,0,0,true,true,true,-1.0
1,2,0.5,0.5,false,true,850,300,848,298,-2,-2,2,true,true,true,-1.0
1,2,0.5,0.5,false,true,300,250,298,248,-2,-2,2,true,true,true,-1.0
1,2,0.5,0.5,false,true,200,200,849,299,649,99,1,true,true,true,-1.0
1,2,0.5,0.5,false,true,300,900,298,898,-2,-2,2,true,true,true,-1.0
1,2,0.5,0.5,false,true,900,300,898,298,-2,-2,2,true,true,true,-1.0
1,2,0.5,0.5,false,true,200,350,799,949,599,599,1,true,true,true,-1.0
1,2,0.5,0.5,false,true,850,300,850,300,0,0,0,true,true,true,-1.0
1,2,0.5,0.5,false,false,200,200,199,199,-1,-1,1,true,true,true,82.163
1,2,0.5,0.5,false,false,300,300,299,299,-1,-1,1,true,true,true,-1.0
1,2,0.5,0.5,false,false,200,850,799,899,599,49,1,true,true,true,-1.0
1,2,0.5,0.5,false,false,250,250,349,799,99,549,1,true,true,true,-1.0
1,2,0.5,0.5,false,false,250,300,248,298,-2,-2,2,true,true,true,-1.0
1,2,0.5,0.5,false,false,350,250,334,234,-16,-16,16,true,true,true,-1.0
1,2,0.5,0.5,false,false,250,850,248,848,-2,-2,2,true,true,true,-1.0
1,2,0.5,0.5,false,false,200,250,249,299,49,49,1,true,true,true,-1.0
1,2,0.5,0.5,false,false,350,200,899,299,549,99,1,true,true,true,-1.0
1,2,0.5,0.5,false,false,300,200,348,298,48,98,2,true,true,true,-1.0
1,2,0.5,0.5,false,false,250,200,250,200,0,0,0,true,true,true,-1.0
1,2,0.5,0.5,false,false,300,300,298,298,-2,-2,2,true,true,true,-1.0
1,2,0.5,0.5,false,false,200,200,198,198,-2,-2,2,true,true,true,-1.0
1,2,0.5,0.5,false,false,250,250,204,204,-46,-46,46,true,true,true,-1.0
1,2,0.5,0.5,false,false,300,350,773,373,473,23,27,true,true,true,-1.0
1,2,0.5,0.5,false,false,300,850,300,850,0,0,0,true,true,true,-1.0
1,2,0.5,0.5,false,false,300,300,299,299,-1,-1,1,true,true,true,-1.0
1,2,0.5,0.5,false,false,300,250,831,281,531,31,19,true,true,true,-1.0
1,2,0.5,0.5,false,false,250,850,250,850,0,0,0,true,true,true,-1.0
1,2,0.5,0.5,false,false,200,300,799,349,599,49,1,true,true,true,-1.0
2,0,0.5,0.5,true,false,300,300,799,349,499,49,1,true,true,true,584.333
2,0,0.5,0.5,true,false,300,850,297,847,-3,-3,3,true,true,true,-1.0
2,0,0.5,0.5,true,false,250,200,297,247,47,47,3,true,false,true,-1.0
2,0,0.5,0.5,true,false,300,200,797,247,497,47,3,true,true,true,-1.0
2,0,0.5,0.5,true,false,300,250,797,347,497,97,3,true,true,true,-1.0
2,0,0.5,0.5,true,false,300,300,297,297,-3,-3,3,true,true,true,-1.0
2,0,0.5,0.5,true,false,300,200,300,200,0,0,0,true,true,true,-1.0
2,0,0.5,0.5,true,false,900,250,895,245,-5,-5,5,true,true,true,-1.0
2,0,0.5,0.5,true,false,350,300,345,295,-5,-5,5,true,true,true,-1.0
2,0,0.5,0.5,true,false,200,850,197,847,-3,-3,3,false,false,false,-1.0
2,0,0.5,0.5,true,false,300,300,297,297,-3,-3,3,true,true,true,-1.0
2,0,0.5,0.5,true,false,300,850,297,847,-3,-3,3,true,true,true,-1.0
2,0,0.5,0.5,true,false,350,850,350,850,0,0,0,true,true,true,-1.0
2,0,0.5,0.5,true,false,850,300,845,295,-5,-5,5,true,true,true,-1.0
2,0,0.5,0.5,true,false,250,300,247,297,-3,-3,3,true,true,true,-1.0
2,0,0.5,0.5,true,false,300,350,848,898,548,548,2,true,true,true,-1.0
2,0,0.5,0.5,true,false,250,300,797,347,547,47,3,true,true,true,-1.0
2,0,0.5,0.5,true,false,250,300,245,295,-5,-5,5,true,true,true,-1.0
2,0,0.5,0.5,true,false,250,300,245,295,-5,-5,5,true,true,true,-1.0
2,0,0.5,0.5,true,false,250,250,245,245,-5,-5,5,true,true,true,-1.0
2,0,0.5,0.5,false,false,300,250,897,297,597,47,3,true,true,true,111.456
2,0,0.5,0.5,false,false,850,300,845,295,-5,-5,5,true,true,true,-1.0
2,0,0.5,0.5,false,false,350,300,348,298,-2,-2,2,true,true,true,-1.0
2,0,0.5,0.5,false,false,300,250,345,795,45,545,5,true,true,true,-1.0
2,0,0.5,0.5,false,false,850,850,850,850,0,0,0,true,true,true,-1.0
2,0,0.5,0.5,false,false,850,350,847,347,-3,-3,3,true,true,true,-1.0
2,0,0.5,0.5,false,false,300,300,295,295,-5,-5,5,true,true,true,-1.0
2,0,0.5,0.5,false,false,250,250,250,250,0,0,0,false,false,false,-1.0
2,0,0.5,0.5,false,false,850,300,898,798,48,498,2,true,true,true,-1.0
2,0,0.5,0.5,false,false,300,200,300,200,0,0,0,true,true,true,-1.0
2,0,0.5,0.5,false,false,300,300,798,948,498,648,2,true,true,true,-1.0
2,0,0.5,0.5,false,false,200,300,248,798,48,498,2,true,true,true,-1.0
2,0,0.5,0.5,false,false,850,300,850,300,0,0,0,true,true,true,-1.0
2,0,0.5,0.5,false,false,350,200,345,195,-5,-5,5,true,true,true,-1.0
2,0,0.5,0.5,false,false,300,250,797,297,497,47,3,true,true,true,-1.0
2,0,0.5,0.5,false,false,300,200,347,247,47,47,3,true,true,true,-1.0
2,0,0.5,0.5,false,false,300,850,797,897,497,47,3,true,true,true,-1.0
2,0,0.5,0.5,false,false,200,300,197,297,-3,-3,3,true,true,true,-1.0
2,0,0.5,0.5,false,false,300,250,347,297,47,47,3,true,true,true,-1.0
2,0,0.5,0.5,false,false,200,300,247,347,47,47,3,true,true,true,-1.0
2,1,0.5,0.5,true,false,250,250,247,247,-3,-3,3,true,true,true,1222.786
2,1,0.5,0.5,true,false,250,850,250,850,0,0,0,true,true,true,-1.0
2,1,0.5,0.5,true,false,200,250,898,798,698,548,2,true,true,true,-1.0
2,1,0.5,0.5,true,false,350,250,350,250,0,0,0,true,true,true,-1.0
2,1,0.5,0.5,true,false,250,200,798,248,548,48,2,true,true,true,-1.0
2,1,0.5,0.5,true,false,300,250,798,348,498,98,2,true,true,true,-1.0
2,1,0.5,0.5,true,false,300,300,797,347,497,47,3,true,true,true,-1.0
2,1,0.5,0.5,true,false,850,250,850,250,0,0,0,true,true,true,-1.0
2,1,0.5,0.5,true,false,350,250,347,247,-3,-3,3,true,true,true,-1.0
2,1,0.5,0.5,true,false,850,200,850,200,0,0,0,true,true,true,-1.0
2,1,0.5,0.5,true,false,300,200,297,197,-3,-3,3,true,true,true,-1.0
2,1,0.5,0.5,true,false,250,300,247,297,-3,-3,3,true,true,true,-1.0
2,1,0.5,0.5,true,false,250,850,247,847,-3,-3,3,true,true,true,-1.0
2,1,0.5,0.5,true,false,200,200,197,197,-3,-3,3,true,true,true,-1.0
2,1,0.5,0.5,true,false,850,200,850,200,0,0,0,true,true,true,-1.0
2,1,0.5,0.5,true,false,250,300,298,798,48,498,2,true,true,true,-1.0
2,1,0.5,0.5,true,false,200,250,399,799,199,549,1,true,true,true,-1.0
2,1,0.5,0.5,true,false,250,200,799,249,549,49,1,true,true,true,-1.0
2,1,0.5,0.5,true,false,350,850,350,850,0,0,0,true,true,true,-1.0
2,1,0.5,0.5,true,false,300,200,300,200,0,0,0,true,true,true,-1.0
2,1,0.5,0.5,false,false,200,250,150,200,-50,-50,50,false,false,false,189.772
2,1,0.5,0.5,false,false,200,300,197,347,-3,47,3,true,true,true,-1.0
2,1,0.5,0.5,false,false,300,300,300,300,0,0,0,true,true,true,-1.0
2,1,0.5,0.5,false,false,250,850,247,847,-3,-3,3,true,true,true,-1.0
2,1,0.5,0.5,false,false,250,200,299,249,49,49,1,true,true,true,-1.0
2,1,0.5,0.5,false,false,300,300,849,849,549,549,1,true,true,true,-1.0
2,1,0.5,0.5,false,false,850,200,899,799,49,599,1,true,true,true,-1.0
2,1,0.5,0.5,false,false,300,850,297,847,-3,-3,3,true,true,true,-1.0
2,1,0.5,0.5,false,false,250,350,290,390,40,40,10,true,true,true,-1.0
2,1,0.5,0.5,false,false,300,850,797,897,497,47,3,true,true,true,-1.0
2,1,0.5,0.5,false,false,250,850,245,845,-5,-5,5,true,true,true,-1.0
2,1,0.5,0.5,false,false,850,350,847,347,-3,-3,3,true,true,true,-1.0
2,1,0.5,0.5,false,false,250,250,247,247,-3,-3,3,true,true,true,-1.0
2,1,0.5,0.5,false,false,300,200,797,247,497,47,3,true,true,true,-1.0
2,1,0.5,0.5,false,false,300,200,897,297,597,97,3,true,true,true,-1.0
2,1,0.5,0.5,false,false,850,300,850,300,0,0,0,true,true,true,-1.0
2,1,0.5,0.5,false,false,350,300,898,898,548,598,2,true,true,true,-1.0
2,1,0.5,0.5,false,false,300,200,798,398,498,198,2,true,true,true,-1.0
2,1,0.5,0.5,false,false,200,200,197,197,-3,-3,3,true,true,true,-1.0
2,1,0.5,0.5,false,false,300,300,297,297,-3,-3,3,true,true,true,-1.0
2,2,0.5,0.5,true,true,250,250,249,249,-1,-1,1,true,true,true,661.359
2,2,0.5,0.5,true,true,200,300,199,299,-1,-1,1,true,true,true,-1.0
2,2,0.5,0.5,true,true,200,300,199,299,-1,-1,1,true,true,true,-1.0
2,2,0.5,0.5,true,true,200,250,849,849,649,599,1,true,true,true,-1.0
2,2,0.5,0.5,true,true,900,250,900,250,0,0,0,true,true,true,-1.0
2,2,0.5,0.5,true,true,300,850,299,849,-1,-1,1,true,true,true,-1.0
2,2,0.5,0.5,true,true,850,850,849,849,-1,-1,1,true,true,true,-1.0
2,2,0.5,0.5,true,true,850,300,849,299,-1,-1,1,true,true,true,-1.0
2,2,0.5,0.5,true,true,300,350,797,947,497,597,3,true,true,true,-1.0
2,2,0.5,0.5,true,true,250,250,249,249,-1,-1,1,false,false,false,-1.0
2,2,0.5,0.5,true,true,850,350,850,350,0,0,0,true,true,true,-1.0
2,2,0.5,0.5,true,true,250,300,298,898,48,598,2,true,false,true,-1.0
2,2,0.5,0.5,true,true,300,250,898,848,598,598,2,true,true,true,-1.0
2,2,0.5,0.5,true,true,300,300,300,300,0,0,0,true,true,true,-1.0
2,2,0.5,0.5,true,true,300,250,250,200,-50,-50,50,false,false,false,-1.0
2,2,0.5,0.5,true,true,300,300,299,299,-1,-1,1,true,true,true,-1.0
2,2,0.5,0.5,true,true,200,200,249,249,49,49,1,true,true,true,-1.0
2,2,0.5,0.5,true,true,850,250,849,249,-1,-1,1,true,true,true,-1.0
2,2,0.5,0.5,true,true,300,350,297,347,-3,-3,3,true,true,true,-1.0
2,2,0.5,0.5,true,true,300,900,299,899,-1,-1,1,true,true,true,-1.0
2,2,0.5,0.5,true,false,350,250,349,249,-1,-1,1,true,true,true,344.719
2,2,0.5,0.5,true,false,850,200,898,248,48,48,2,true,true,true,-1.0
2,2,0.5,0.5,true,false,250,200,249,199,-1,-1,1,true,true,true,-1.0
2,2,0.5,0.5,true,false,250,250,797,297,547,47,3,true,false,true,-1.0
2,2,0.5,0.5,true,false,300,250,299,249,-1,-1,1,true,true,true,-1.0
2,2,0.5,0.5,true,false,200,850,199,849,-1,-1,1,true,true,true,-1.0
2,2,0.5,0.5,true,false,250,300,249,299,-1,-1,1,true,true,true,-1.0
2,2,0.5,0.5,true,false,250,300,799,349,549,49,1,true,true,true,-1.0
2,2,0.5,0.5,true,false,300,300,299,299,-1,-1,1,true,true,true,-1.0
2,2,0.5,0.5,true,false,850,250,850,250,0,0,0,true,true,true,-1.0
2,2,0.5,0.5,true,false,300,300,349,799,49,499,1,true,true,true,-1.0
2,2,0.5,0.5,true,false,850,850,849,849,-1,-1,1,true,true,true,-1.0
2,2,0.5,0.5,true,false,350,850,349,849,-1,-1,1,true,true,true,-1.0
2,2,0.5,0.5,true,false,850,300,850,300,0,0,0,true,true,true,-1.0
2,2,0.5,0.5,true,false,300,250,299,249,-1,-1,1,true,true,true,-1.0
2,2,0.5,0.5,true,false,250,200,898,798,648,598,2,true,true,true,-1.0
2,2,0.5,0.5,true,false,300,300,299,299,-1,-1,1,true,true,true,-1.0
2,2,0.5,0.5,true,false,300,300,300,300,0,0,0,true,true,true,-1.0
2,2,0.5,0.5,true,false,250,350,298,898,48,548,2,true,true,true,-1.0
2,2,0.5,0.5,true,false,250,850,249,849,-1,-1,1,true,true,true,-1.0
2,2,0.5,0.5,false,true,300,850,300,850,0,0,0,true,true,true,143.343
2,2,0.5,0.5,false,true,300,250,348,798,48,548,2,true,true,true,-1.0
2,2,0.5,0.5,false,true,300,250,300,250,0,0,0,true,true,true,-1.0
2,2,0.5,0.5,false,true,200,850,198,848,-2,-2,2,true,true,true,-1.0
2,2,0.5,0.5,false,true,250,250,798,298,548,48,2,true,true,true,-1.0
2,2,0.5,0.5,false,true,250,850,248,848,-2,-2,2,true,true,true,-1.0
2,2,0.5,0.5,false,true,300,250,299,249,-1,-1,1,true,true,true,-1.0
2,2,0.5,0.5,false,true,300,850,300,850,0,0,0,true,true,true,-1.0
2,2,0.5,0.5,false,true,300,300,797,347,497,47,3,true,true,true,-1.0
2,2,0.5,0.5,false,true,200,300,249,799,49,499,1,true,true,true,-1.0
2,2,0.5,0.5,false,true,250,350,298,898,48,548,2,true,false,true,-1.0
2,2,0.5,0.5,false,true,350,200,349,199,-1,-1,1,true,true,true,-1.0
2,2,0.5,0.5,false,true,300,300,299,299,-1,-1,1,true,true,true,-1.0
2,2,0.5,0.5,false,true,200,200,200,200,0,0,0,true,true,true,-1.0
2,2,0.5,0.5,false,true,250,250,250,250,0,0,0,true,true,true,-1.0
2,2,0.5,0.5,false,true,850,350,849,349,-1,-1,1,true,true,true,-1.0
2,2,0.5,0.5,false,true,200,200,200,200,0,0,0,true,true,true,-1.0
2,2,0.5,0.5,false,true,250,850,249,849,-1,-1,1,true,true,true,-1.0
2,2,0.5,0.5,false,true,350,200,349,199,-1,-1,1,true,true,true,-1.0
2,2,0.5,0.5,false,true,300,250,298,248,-2,-2,2,true,true,true,-1.0
2,2,0.5,0.5,false,false,200,300,238,888,38,588,12,true,true,true,93.191
2,2,0.5,0.5,false,false,300,850,798,898,498,48,2,true,true,true,-1.0
2,2,0.5,0.5,false,false,300,850,299,849,-1,-1,1,true,true,true,-1.0
2,2,0.5,0.5,false,false,350,250,399,299,49,49,1,true,true,true,-1.0
2,2,0.5,0.5,false,false,350,250,349,249,-1,-1,1,true,true,true,-1.0
2,2,0.5,0.5,false,false,200,300,198,298,-2,-2,2,true,true,true,-1.0
2,2,0.5,0.5,false,false,300,300,300,300,0,0,0,true,true,true,-1.0
2,2,0.5,0.5,false,false,350,250,898,298,548,48,2,true,true,true,-1.0
2,2,0.5,0.5,false,false,300,850,299,849,-1,-1,1,true,true,true,-1.0
2,2,0.5,0.5,false,false,250,850,250,850,0,0,0,true,true,true,-1.0
2,2,0.5,0.5,false,false,200,300,198,298,-2,-2,2,true,true,true,-1.0
2,2,0.5,0.5,false,false,250,300,298,798,48,498,2,true,true,true,-1.0
2,2,0.5,0.5,false,false,300,200,798,298,498,98,2,true,true,true,-1.0
2,2,0.5,0.5,false,false,200,250,199,249,-1,-1,1,true,true,true,-1.0
2,2,0.5,0.5,false,false,350,900,349,899,-1,-1,1,true,true,true,-1.0
2,2,0.5,0.5,false,false,200,300,248,348,48,48,2,true,true,true,-1.0
2,2,0.5,0.5,false,false,350,300,349,299,-1,-1,1,true,true,true,-1.0
2,2,0.5,0.5,false,false,250,200,249,199,-1,-1,1,true,true,true,-1.0
2,2,0.5,0.5,false,false,250,250,248,248,-2,-2,2,true,true,true,-1.0
2,2,0.5,0.5,false,false,850,300,849,299,-1,-1,1,true,true,true,-1.0
0,0,0.5,0.5,false,false,900,200,896,196,-4,-4,4,true,true,true,0.184
0,0,0.5,0.5,false,false,200,300,197,297,-3,-3,3,false,false,false,-1.0
0,0,0.5,0.5,false,false,300,250,799,899,499,649,1,true,true,true,-1.0
0,0,0.5,0.5,false,false,300,350,297,347,-3,-3,3,true,true,true,-1.0
0,0,0.5,0.5,false,false,300,300,297,297,-3,-3,3,true,true,true,-1.0
0,0,0.5,0.5,false,false,200,850,198,848,-2,-2,2,true,true,true,-1.0
0,0,0.5,0.5,false,false,300,250,799,299,499,49,1,true,true,true,-1.0
0,0,0.5,0.5,false,false,850,850,848,848,-2,-2,2,true,true,true,-1.0
0,0,0.5,0.5,false,false,200,300,197,297,-3,-3,3,true,true,true,-1.0
0,0,0.5,0.5,false,false,850,250,847,247,-3,-3,3,true,true,true,-1.0
0,0,0.5,0.5,false,false,200,900,197,897,-3,-3,3,true,true,true,-1.0
0,0,0.5,0.5,false,false,300,200,298,198,-2,-2,2,true,true,true,-1.0
0,0,0.5,0.5,false,false,350,350,346,346,-4,-4,4,false,false,false,-1.0
0,0,0.5,0.5,false,false,250,250,348,798,98,548,2,true,true,true,-1.0
0,0,0.5,0.5,false,false,300,850,799,899,499,49,1,true,true,true,-1.0
0,0,0.5,0.5,false,false,900,900,898,898,-2,-2,2,true,true,true,-1.0
0,0,0.5,0.5,false,false,850,200,848,198,-2,-2,2,true,true,true,-1.0
0,0,0.5,0.5,false,false,300,250,797,297,497,47,3,true,true,true,-1.0
0,0,0.5,0.5,false,false,900,250,897,247,-3,-3,3,true,true,true,-1.0
0,0,0.5,0.5,false,false,850,250,848,248,-2,-2,2,true,true,true,-1.0
0,1,0.5,0.5,false,false,300,300,296,296,-4,-4,4,true,true,true,0.302
0,1,0.5,0.5,false,false,300,300,396,796,96,496,4,true,true,true,-1.0
0,1,0.5,0.5,false,false,200,300,197,297,-3,-3,3,true,true,true,-1.0
0,1,0.5,0.5,false,false,200,350,798,948,598,598,2,true,true,true,-1.0
0,1,0.5,0.5,false,false,200,250,298,798,98,548,2,true,true,true,-1.0
0,1,0.5,0.5,false,false,250,300,799,949,549,649,1,true,true,true,-1.0
0,1,0.5,0.5,false,false,900,300,896,296,-4,-4,4,true,true,true,-1.0
0,1,0.5,0.5,false,false,300,300,799,349,499,49,1,true,true,true,-1.0
0,1,0.5,0.5,false,false,200,300,799,949,599,649,1,true,true,true,-1.0
0,1,0.5,0.5,false,false,300,200,296,196,-4,-4,4,true,true,true,-1.0
0,1,0.5,0.5,false,false,250,200,298,248,48,48,2,true,true,true,-1.0
0,1,0.5,0.5,false,false,200,250,797,347,597,97,3,true,true,true,-1.0
0,1,0.5,0.5,false,false,900,250,899,249,-1,-1,1,true,true,true,-1.0
0,1,0.5,0.5,false,false,250,200,347,297,97,97,3,true,true,true,-1.0
0,1,0.5,0.5,false,false,850,350,846,346,-4,-4,4,true,true,true,-1.0
0,1,0.5,0.5,false,false,200,200,197,197,-3,-3,3,true,true,true,-1.0
0,1,0.5,0.5,false,false,250,300,799,899,549,599,1,true,true,true,-1.0
0,1,0.5,0.5,false,false,200,250,248,898,48,648,2,true,true,true,-1.0
0,1,0.5,0.5,false,false,850,300,897,797,47,497,3,true,true,true,-1.0
0,1,0.5,0.5,false,false,900,300,948,798,48,498,2,true,true,true,-1.0
0,2,0.5,0.5,false,true,300,350,299,349,-1,-1,1,true,true,true,348.274
0,2,0.5,0.5,false,true,200,300,248,898,48,598,2,true,false,true,-1.0
0,2,0.5,0.5,false,true,250,250,298,898,48,648,2,true,true,true,-1.0
0,2,0.5,0.5,false,true,900,300,897,297,-3,-3,3,true,true,true,-1.0
0,2,0.5,0.5,false,true,250,300,296,346,46,46,4,true,true,true,-1.0
0,2,0.5,0.5,false,true,850,250,846,246,-4,-4,4,true,true,true,-1.0
0,2,0.5,0.5,false,true,300,250,296,246,-4,-4,4,false,false,false,-1.0
0,2,0.5,0.5,false,true,350,250,398,798,48,548,2,true,true,true,-1.0
0,2,0.5,0.5,false,true,250,900,244,894,-6,-6,6,true,true,true,-1.0
0,2,0.5,0.5,false,true,900,300,896,296,-4,-4,4,true,true,true,-1.0
0,2,0.5,0.5,false,true,250,250,298,798,48,548,2,true,false,true,-1.0
0,2,0.5,0.5,false,true,300,300,799,399,499,99,1,true,true,true,-1.0
0,2,0.5,0.5,false,true,300,300,346,796,46,496,4,true,true,true,-1.0
0,2,0.5,0.5,false,true,300,300,799,349,499,49,1,true,true,true,-1.0
0,2,0.5,0.5,false,true,300,900,296,896,-4,-4,4,true,true,true,-1.0
0,2,0.5,0.5,false,true,300,900,297,897,-3,-3,3,true,true,true,-1.0
0,2,0.5,0.5,false,true,300,850,296,846,-4,-4,4,true,true,true,-1.0
0,2,0.5,0.5,false,true,350,350,346,346,-4,-4,4,true,true,true,-1.0
0,2,0.5,0.5,false,true,300,300,799,349,499,49,1,true,true,true,-1.0
0,2,0.5,0.5,false,true,300,250,348,798,48,548,2,true,false,true,-1.0
0,2,0.5,0.5,false,false,850,250,846,246,-4,-4,4,true,true,true,70.003
0,2,0.5,0.5,false,false,300,850,797,897,497,47,3,true,true,true,-1.0
0,2,0.5,0.5,false,false,350,200,346,196,-4,-4,4,true,true,true,-1.0
0,2,0.5,0.5,false,false,250,250,298,798,48,548,2,true,true,true,-1.0
0,2,0.5,0.5,false,false,300,300,848,898,548,598,2,true,true,true,-1.0
0,2,0.5,0.5,false,false,350,300,398,798,48,498,2,true,true,true,-1.0
0,2,0.5,0.5,false,false,350,300,398,798,48,498,2,true,true,true,-1.0
0,2,0.5,0.5,false,false,850,250,898,798,48,548,2,true,true,true,-1.0
0,2,0.5,0.5,false,false,250,250,298,798,48,548,2,true,true,true,-1.0
0,2,0.5,0.5,false,false,250,300,848,898,598,598,2,true,true,true,-1.0
0,2,0.5,0.5,false,false,250,300,244,294,-6,-6,6,false,false,false,-1.0
0,2,0.5,0.5,false,false,300,850,296,846,-4,-4,4,true,true,true,-1.0
0,2,0.5,0.5,false,false,300,850,799,899,499,49,1,true,true,true,-1.0
0,2,0.5,0.5,false,false,300,850,297,847,-3,-3,3,true,true,true,-1.0
0,2,0.5,0.5,false,false,350,250,396,796,46,546,4,true,true,true,-1.0
0,2,0.5,0.5,false,false,850,300,849,299,-1,-1,1,true,true,true,-1.0
0,2,0.5,0.5,false,false,200,300,248,348,48,48,2,true,true,true,-1.0
0,2,0.5,0.5,false,false,250,850,247,847,-3,-3,3,true,true,true,-1.0
0,2,0.5,0.5,false,false,250,300,298,848,48,548,2,true,true,true,-1.0
0,2,0.5,0.5,false,false,900,300,948,798,48,498,2,true,true,true,-1.0
1,0,0.5,0.5,false,false,850,300,850,300,0,0,0,true,true,true,0.337
1,0,0.5,0.5,false,false,200,300,299,349,99,49,1,true,true,true,-1.0
1,0,0.5,0.5,false,false,850,200,850,200,0,0,0,true,true,true,-1.0
1,0,0.5,0.5,false,false,250,200,898,798,648,598,2,true,true,true,-1.0
1,0,0.5,0.5,false,false,200,850,197,847,-3,-3,3,true,true,true,-1.0
1,0,0.5,0.5,false,false,200,250,247,297,47,47,3,true,true,true,-1.0
1,0,0.5,0.5,false,false,850,900,847,897,-3,-3,3,true,true,true,-1.0
1,0,0.5,0.5,false,false,250,300,797,397,547,97,3,true,true,true,-1.0
1,0,0.5,0.5,false,false,350,300,345,295,-5,-5,5,true,true,true,-1.0
1,0,0.5,0.5,false,false,300,200,847,247,547,47,3,true,true,true,-1.0
1,0,0.5,0.5,false,false,900,250,900,250,0,0,0,true,true,true,-1.0
1,0,0.5,0.5,false,false,250,200,849,849,599,649,1,true,true,true,-1.0
1,0,0.5,0.5,false,false,250,200,948,798,698,598,2,true,true,true,-1.0
1,0,0.5,0.5,false,false,300,850,297,847,-3,-3,3,true,true,true,-1.0
1,0,0.5,0.5,false,false,300,250,297,247,-3,-3,3,true,true,true,-1.0
1,0,0.5,0.5,false,false,250,250,799,899,549,649,1,true,true,true,-1.0
1,0,0.5,0.5,false,false,300,350,295,345,-5,-5,5,false,false,false,-1.0
1,0,0.5,0.5,false,false,200,200,197,197,-3,-3,3,true,true,true,-1.0
1,0,0.5,0.5,false,false,250,200,846,246,596,46,4,true,false,true,-1.0
1,0,0.5,0.5,false,false,350,200,347,197,-3,-3,3,true,true,true,-1.0
1,1,0.5,0.5,false,false,850,300,800,250,-50,-50,50,true,true,true,1.361
1,1,0.5,0.5,false,false,250,200,247,197,-3,-3,3,true,true,true,-1.0
1,1,0.5,0.5,false,false,200,350,150,300,-50,-50,50,false,false,false,-1.0
1,1,0.5,0.5,false,false,250,850,247,847,-3,-3,3,true,true,true,-1.0
1,1,0.5,0.5,false,false,250,350,200,300,-50,-50,50,true,true,true,-1.0
1,1,0.5,0.5,false,false,200,250,150,200,-50,-50,50,false,false,false,-1.0
1,1,0.5,0.5,false,false,350,300,398,798,48,498,2,true,true,true,-1.0
1,1,0.5,0.5,false,false,200,250,246,346,46,96,4,true,true,true,-1.0
1,1,0.5,0.5,false,false,850,300,848,298,-2,-2,2,true,true,true,-1.0
1,1,0.5,0.5,false,false,250,250,200,200,-50,-50,50,false,false,false,-1.0
1,1,0.5,0.5,false,false,850,200,896,796,46,596,4,true,true,true,-1.0
1,1,0.5,0.5,false,false,300,200,300,200,0,0,0,true,true,true,-1.0
1,1,0.5,0.5,false,false,900,200,900,200,0,0,0,true,true,true,-1.0
1,1,0.5,0.5,false,false,850,200,850,200,0,0,0,true,true,true,-1.0
1,1,0.5,0.5,false,false,250,850,247,847,-3,-3,3,true,true,true,-1.0
1,1,0.5,0.5,false,false,250,850,249,849,-1,-1,1,true,true,true,-1.0
1,1,0.5,0.5,false,false,200,300,899,799,699,499,1,true,true,true,-1.0
1,1,0.5,0.5,false,false,300,900,799,949,499,49,1,true,true,true,-1.0
1,1,0.5,0.5,false,false,250,300,200,250,-50,-50,50,true,true,true,-1.0
1,1,0.5,0.5,false,false,250,300,200,250,-50,-50,50,true,true,true,-1.0
1,2,0.5,0.5,false,true,300,250,298,248,-2,-2,2,true,true,true,535.134
1,2,0.5,0.5,false,true,300,850,299,849,-1,-1,1,true,true,true,-1.0
1,2,0.5,0.5,false,true,300,850,300,850,0,0,0,true,true,true,-1.0
1,2,0.5,0.5,false,true,250,250,250,250,0,0,0,false,false,false,-1.0
1,2,0.5,0.5,false,true,200,250,199,249,-1,-1,1,true,true,true,-1.0
1,2,0.5,0.5,false,true,850,250,850,250,0,0,0,true,true,true,-1.0
1,2,0.5,0.5,false,true,300,900,298,898,-2,-2,2,true,true,true,-1.0
1,2,0.5,0.5,false,true,200,250,349,799,149,549,1,true,false,true,-1.0
1,2,0.5,0.5,false,true,850,250,847,297,-3,47,3,true,true,true,-1.0
1,2,0.5,0.5,false,true,200,350,848,898,648,548,2,true,true,true,-1.0
1,2,0.5,0.5,false,true,850,350,850,350,0,0,0,true,true,true,-1.0
1,2,0.5,0.5,false,true,900,850,900,850,0,0,0,true,true,true,-1.0
1,2,0.5,0.5,false,true,850,850,848,848,-2,-2,2,true,true,true,-1.0
1,2,0.5,0.5,false,true,300,300,300,300,0,0,0,true,true,true,-1.0
1,2,0.5,0.5,false,true,300,200,300,200,0,0,0,true,true,true,-1.0
1,2,0.5,0.5,false,true,250,350,797,947,547,597,3,true,true,true,-1.0
1,2,0.5,0.5,false,true,250,250,898,798,648,548,2,true,true,true,-1.0
1,2,0.5,0.5,false,true,850,250,848,248,-2,-2,2,true,true,true,-1.0
1,2,0.5,0.5,false,true,250,250,200,200,-50,-50,50,false,false,false,-1.0
1,2,0.5,0.5,false,true,250,350,298,898,48,548,2,true,false,true,-1.0
1,2,0.5,0.5,false,false,200,350,198,348,-2,-2,2,true,true,true,54.668
1,2,0.5,0.5,false,false,200,300,199,299,-1,-1,1,true,true,true,-1.0
1,2,0.5,0.5,false,false,200,300,848,848,648,548,2,true,true,true,-1.0
1,2,0.5,0.5,false,false,300,300,347,797,47,497,3,true,true,true,-1.0
1,2,0.5,0.5,false,false,250,350,298,898,48,548,2,true,true,true,-1.0
1,2,0.5,0.5,false,false,300,200,349,299,49,99,1,true,true,true,-1.0
1,2,0.5,0.5,false,false,300,300,286,286,-14,-14,14,true,true,true,-1.0
1,2,0.5,0.5,false,false,350,200,399,799,49,599,1,true,true,true,-1.0
1,2,0.5,0.5,false,false,200,300,296,846,96,546,4,true,false,true,-1.0
1,2,0.5,0.5,false,false,250,300,298,798,48,498,2,true,true,true,-1.0
1,2,0.5,0.5,false,false,200,250,198,248,-2,-2,2,true,true,true,-1.0
1,2,0.5,0.5,false,false,250,300,248,298,-2,-2,2,true,true,true,-1.0
1,2,0.5,0.5,false,false,300,200,300,200,0,0,0,true,true,true,-1.0
1,2,0.5,0.5,false,false,200,300,799,349,599,49,1,true,true,true,-1.0
1,2,0.5,0.5,false,false,850,350,850,350,0,0,0,true,true,true,-1.0
1,2,0.5,0.5,false,false,300,300,798,348,498,48,2,true,true,true,-1.0
1,2,0.5,0.5,false,false,300,250,296,246,-4,-4,4,true,true,true,-1.0
1,2,0.5,0.5,false,false,250,250,299,799,49,549,1,true,true,true,-1.0
1,2,0.5,0.5,false,false,300,300,300,300,0,0,0,true,true,true,-1.0
1,2,0.5,0.5,false,false,300,200,300,200,0,0,0,false,false,false,-1.0
2,0,0.5,0.5,true,false,300,850,297,847,-3,-3,3,true,true,true,551.136
2,0,0.5,0.5,true,false,300,300,297,297,-3,-3,3,true,true,true,-1.0
2,0,0.5,0.5,true,false,300,850,799,899,499,49,1,true,true,true,-1.0
2,0,0.5,0.5,true,false,850,250,850,250,0,0,0,true,true,true,-1.0
2,0,0.5,0.5,true,false,250,250,245,245,-5,-5,5,false,false,false,-1.0
2,0,0.5,0.5,true,false,250,850,797,897,547,47,3,true,true,true,-1.0
2,0,0.5,0.5,true,false,300,300,798,348,498,48,2,true,true,true,-1.0
2,0,0.5,0.5,true,false,200,300,249,349,49,49,1,true,true,true,-1.0
2,0,0.5,0.5,true,false,300,850,799,899,499,49,1,true,true,true,-1.0
2,0,0.5,0.5,true,false,200,300,197,297,-3,-3,3,true,true,true,-1.0
2,0,0.5,0.5,true,false,300,300,297,297,-3,-3,3,true,true,true,-1.0
2,0,0.5,0.5,true,false,900,350,896,346,-4,-4,4,true,true,true,-1.0
2,0,0.5,0.5,true,false,350,200,350,200,0,0,0,true,true,true,-1.0
2,0,0.5,0.5,true,false,300,300,898,798,598,498,2,true,true,true,-1.0
2,0,0.5,0.5,true,false,300,300,348,798,48,498,2,true,true,true,-1.0
2,0,0.5,0.5,true,false,250,300,247,297,-3,-3,3,true,true,true,-1.0
2,0,0.5,0.5,true,false,300,300,297,297,-3,-3,3,false,false,false,-1.0
2,0,0.5,0.5,true,false,250,350,245,345,-5,-5,5,false,false,false,-1.0
2,0,0.5,0.5,true,false,350,300,350,300,0,0,0,true,true,true,-1.0
2,0,0.5,0.5,true,false,300,250,799,299,499,49,1,true,true,true,-1.0
2,0,0.5,0.5,false,false,250,200,348,798,98,598,2,true,true,true,77.168
2,0,0.5,0.5,false,false,300,300,847,847,547,547,3,true,true,true,-1.0
2,0,0.5,0.5,false,false,850,250,845,245,-5,-5,5,true,true,true,-1.0
2,0,0.5,0.5,false,false,300,250,948,798,648,548,2,true,true,true,-1.0
2,0,0.5,0.5,false,false,350,200,397,247,47,47,3,true,true,true,-1.0
2,0,0.5,0.5,false,false,850,300,845,295,-5,-5,5,true,true,true,-1.0
2,0,0.5,0.5,false,false,250,200,299,849,49,649,1,true,true,true,-1.0
2,0,0.5,0.5,false,false,300,300,346,796,46,496,4,true,true,true,-1.0
2,0,0.5,0.5,false,false,250,900,247,897,-3,-3,3,true,true,true,-1.0
2,0,0.5,0.5,false,false,300,250,300,250,0,0,0,true,true,true,-1.0
2,0,0.5,0.5,false,false,200,300,195,295,-5,-5,5,true,true,true,-1.0
2,0,0.5,0.5,false,false,300,300,295,295,-5,-5,5,false,false,false,-1.0
2,0,0.5,0.5,false,false,250,200,250,200,0,0,0,true,true,true,-1.0
2,0,0.5,0.5,false,false,250,350,245,345,-5,-5,5,true,true,true,-1.0
2,0,0.5,0.5,false,false,850,300,850,300,0,0,0,true,true,true,-1.0
2,0,0.5,0.5,false,false,200,850,197,847,-3,-3,3,true,true,true,-1.0
2,0,0.5,0.5,false,false,200,300,195,295,-5,-5,5,false,false,false,-1.0
2,0,0.5,0.5,false,false,250,350,797,397,547,47,3,true,true,true,-1.0
2,0,0.5,0.5,false,false,900,850,897,847,-3,-3,3,true,true,true,-1.0
2,0,0.5,0.5,false,false,850,200,897,297,47,97,3,true,true,true,-1.0
2,1,0.5,0.5,true,false,250,850,200,800,-50,-50,50,false,false,false,935.499
2,1,0.5,0.5,true,false,900,850,897,847,-3,-3,3,true,true,true,-1.0
2,1,0.5,0.5,true,false,200,300,348,798,148,498,2,true,true,true,-1.0
2,1,0.5,0.5,true,false,250,350,797,397,547,47,3,true,true,true,-1.0
2,1,0.5,0.5,true,false,300,900,297,897,-3,-3,3,true,true,true,-1.0
2,1,0.5,0.5,true,false,250,200,349,799,99,599,1,true,true,true,-1.0
2,1,0.5,0.5,true,false,900,900,900,900,0,0,0,true,true,true,-1.0
2,1,0.5,0.5,true,false,850,300,847,297,-3,-3,3,true,true,true,-1.0
2,1,0.5,0.5,true,false,850,350,847,347,-3,-3,3,true,true,true,-1.0
2,1,0.5,0.5,true,false,300,250,297,247,-3,-3,3,true,true,true,-1.0
2,1,0.5,0.5,true,false,300,300,297,297,-3,-3,3,true,true,true,-1.0
2,1,0.5,0.5,true,false,200,300,799,349,599,49,1,true,true,true,-1.0
2,1,0.5,0.5,true,false,250,250,247,247,-3,-3,3,true,true,true,-1.0
2,1,0.5,0.5,true,false,300,300,799,899,499,599,1,true,true,true,-1.0
2,1,0.5,0.5,true,false,300,200,300,200,0,0,0,true,true,true,-1.0
2,1,0.5,0.5,true,false,850,200,850,200,0,0,0,true,true,true,-1.0
2,1,0.5,0.5,true,false,300,300,346,796,46,496,4,true,true,true,-1.0
2,1,0.5,0.5,true,false,300,300,797,397,497,97,3,true,true,true,-1.0
2,1,0.5,0.5,true,false,900,300,948,798,48,498,2,true,true,true,-1.0
2,1,0.5,0.5,true,false,300,250,797,297,497,47,3,true,true,true,-1.0
2,1,0.5,0.5,false,false,300,250,300,250,0,0,0,true,true,true,171.641
2,1,0.5,0.5,false,false,300,350,297,347,-3,-3,3,true,true,true,-1.0
2,1,0.5,0.5,false,false,250,250,798,898,548,648,2,true,true,true,-1.0
2,1,0.5,0.5,false,false,200,300,298,798,98,498,2,true,true,true,-1.0
2,1,0.5,0.5,false,false,250,850,247,847,-3,-3,3,true,true,true,-1.0
2,1,0.5,0.5,false,false,850,200,850,200,0,0,0,true,true,true,-1.0
2,1,0.5,0.5,false,false,250,850,250,850,0,0,0,true,true,true,-1.0
2,1,0.5,0.5,false,false,200,250,197,247,-3,-3,3,true,true,true,-1.0
2,1,0.5,0.5,false,false,900,200,900,200,0,0,0,true,true,true,-1.0
2,1,0.5,0.5,false,false,300,850,297,847,-3,-3,3,true,true,true,-1.0
2,1,0.5,0.5,false,false,250,300,200,250,-50,-50,50,false,false,false,-1.0
2,1,0.5,0.5,false,false,850,300,899,799,49,499,1,true,true,true,-1.0
2,1,0.5,0.5,false,false,850,200,898,798,48,598,2,true,true,true,-1.0
2,1,0.5,0.5,false,false,850,300,847,297,-3,-3,3,true,true,true,-1.0
2,1,0.5,0.5,false,false,200,250,230,330,30,80,20,true,true,true,-1.0
2,1,0.5,0.5,false,false,850,300,848,298,-2,-2,2,true,true,true,-1.0
2,1,0.5,0.5,false,false,200,300,797,397,597,97,3,true,true,true,-1.0
2,1,0.5,0.5,false,false,300,250,899,799,599,549,1,true,true,true,-1.0
2,1,0.5,0.5,false,false,250,300,247,297,-3,-3,3,true,true,true,-1.0
2,1,0.5,0.5,false,false,250,200,296,796,46,596,4,true,true,true,-1.0
2,2,0.5,0.5,true,true,850,350,849,349,-1,-1,1,true,true,true,565.2
2,2,0.5,0.5,true,true,200,850,199,849,-1,-1,1,true,true,true,-1.0
2,2,0.5,0.5,true,true,300,850,798,898,498,48,2,true,true,true,-1.0
2,2,0.5,0.5,true,true,350,850,349,849,-1,-1,1,true,true,true,-1.0
2,2,0.5,0.5,true,true,850,300,849,299,-1,-1,1,true,true,true,-1.0
2,2,0.5,0.5,true,true,850,350,849,349,-1,-1,1,true,true,true,-1.0
2,2,0.5,0.5,true,true,350,250,349,249,-1,-1,1,true,true,true,-1.0
2,2,0.5,0.5,true,true,850,250,850,250,0,0,0,true,true,true,-1.0
2,2,0.5,0.5,true,true,250,250,248,248,-2,-2,2,true,true,true,-1.0
2,2,0.5,0.5,true,true,350,300,349,299,-1,-1,1,true,true,true,-1.0
2,2,0.5,0.5,true,true,300,300,797,347,497,47,3,true,true,true,-1.0
2,2,0.5,0.5,true,true,850,250,849,249,-1,-1,1,true,true,true,-1.0
2,2,0.5,0.5,true,true,300,300,799,899,499,599,1,true,true,true,-1.0
2,2,0.5,0.5,true,true,300,300,300,300,0,0,0,true,true,true,-1.0
2,2,0.5,0.5,true,true,850,300,850,300,0,0,0,true,true,true,-1.0
2,2,0.5,0.5,true,true,300,300,300,300,0,0,0,true,true,true,-1.0
2,2,0.5,0.5,true,true,850,850,849,849,-1,-1,1,true,true,true,-1.0
2,2,0.5,0.5,true,true,250,350,298,898,48,548,2,true,true,true,-1.0
2,2,0.5,0.5,true,true,350,250,350,250,0,0,0,true,true,true,-1.0
2,2,0.5,0.5,true,true,350,250,347,247,-3,-3,3,true,true,true,-1.0
2,2,0.5,0.5,true,false,200,350,298,898,98,548,2,true,true,true,370.871
2,2,0.5,0.5,true,false,850,300,849,299,-1,-1,1,true,true,true,-1.0
2,2,0.5,0.5,true,false,250,250,299,799,49,549,1,true,true,true,-1.0
2,2,0.5,0.5,true,false,200,200,200,200,0,0,0,true,true,true,-1.0
2,2,0.5,0.5,true,false,850,300,849,299,-1,-1,1,true,true,true,-1.0
2,2,0.5,0.5,true,false,200,250,199,249,-1,-1,1,true,true,true,-1.0
2,2,0.5,0.5,true,false,850,250,849,249,-1,-1,1,true,true,true,-1.0
2,2,0.5,0.5,true,false,300,350,300,350,0,0,0,true,true,true,-1.0
2,2,0.5,0.5,true,false,300,300,787,337,487,37,13,true,true,true,-1.0
2,2,0.5,0.5,true,false,300,350,300,350,0,0,0,true,true,true,-1.0
2,2,0.5,0.5,true,false,250,250,297,297,47,47,3,true,true,true,-1.0
2,2,0.5,0.5,true,false,200,300,198,298,-2,-2,2,true,true,true,-1.0
2,2,0.5,0.5,true,false,350,250,350,250,0,0,0,true,true,true,-1.0
2,2,0.5,0.5,true,false,200,850,198,848,-2,-2,2,true,true,true,-1.0
2,2,0.5,0.5,true,false,200,200,198,198,-2,-2,2,true,true,true,-1.0
2,2,0.5,0.5,true,false,300,300,349,799,49,499,1,true,true,true,-1.0
2,2,0.5,0.5,true,false,350,850,349,849,-1,-1,1,true,true,true,-1.0
2,2,0.5,0.5,true,false,200,300,198,298,-2,-2,2,true,true,true,-1.0
2,2,0.5,0.5,true,false,300,200,797,247,497,47,3,true,true,true,-1.0
2,2,0.5,0.5,true,false,200,300,199,299,-1,-1,1,true,true,true,-1.0
2,2,0.5,0.5,false,true,300,300,799,399,499,99,1,true,true,true,114.986
2,2,0.5,0.5,false,true,300,250,799,299,499,49,1,true,true,true,-1.0
2,2,0.5,0.5,false,true,200,250,200,250,0,0,0,true,true,true,-1.0
2,2,0.5,0.5,false,true,250,350,248,348,-2,-2,2,true,true,true,-1.0
2,2,0.5,0.5,false,true,300,250,798,298,498,48,2,true,true,true,-1.0
2,2,0.5,0.5,false,true,250,200,298,348,48,148,2,true,false,true,-1.0
2,2,0.5,0.5,false,true,300,300,297,297,-3,-3,3,true,true,true,-1.0
2,2,0.5,0.5,false,true,250,300,249,349,-1,49,1,true,true,true,-1.0
2,2,0.5,0.5,false,true,300,250,898,298,598,48,2,true,true,true,-1.0
2,2,0.5,0.5,false,true,300,200,300,200,0,0,0,true,true,true,-1.0
2,2,0.5,0.5,false,true,850,250,849,249,-1,-1,1,true,true,true,-1.0
2,2,0.5,0.5,false,true,900,850,899,849,-1,-1,1,true,true,true,-1.0
2,2,0.5,0.5,false,true,350,350,350,350,0,0,0,true,true,true,-1.0
2,2,0.5,0.5,false,true,200,200,199,199,-1,-1,1,true,true,true,-1.0
2,2,0.5,0.5,false,true,250,200,298,798,48,598,2,true,true,true,-1.0
2,2,0.5,0.5,false,true,850,900,849,899,-1,-1,1,true,true,true,-1.0
2,2,0.5,0.5,false,true,300,300,898,798,598,498,2,true,true,true,-1.0
2,2,0.5,0.5,false,true,250,850,798,898,548,48,2,true,true,true,-1.0
2,2,0.5,0.5,false,true,200,250,150,200,-50,-50,50,false,false,false,-1.0
2,2,0.5,0.5,false,true,350,350,345,345,-5,-5,5,true,true,true,-1.0
2,2,0.5,0.5,false,false,850,250,850,250,0,0,0,true,true,true,87.932
2,2,0.5,0.5,false,false,300,200,798,248,498,48,2,true,true,true,-1.0
2,2,0.5,0.5,false,false,300,250,298,248,-2,-2,2,true,true,true,-1.0
2,2,0.5,0.5,false,false,250,250,249,249,-1,-1,1,true,true,true,-1.0
2,2,0.5,0.5,false,false,250,250,298,348,48,98,2,true,true,true,-1.0
2,2,0.5,0.5,false,false,200,250,247,297,47,47,3,true,true,true,-1.0
2,2,0.5,0.5,false,false,300,300,299,299,-1,-1,1,true,true,true,-1.0
2,2,0.5,0.5,false,false,250,350,250,350,0,0,0,true,true,true,-1.0
2,2,0.5,0.5,false,false,300,250,799,399,499,149,1,true,true,true,-1.0
2,2,0.5,0.5,false,false,300,350,300,350,0,0,0,true,true,true,-1.0
2,2,0.5,0.5,false,false,300,300,898,848,598,548,2,true,true,true,-1.0
2,2,0.5,0.5,false,false,250,250,798,798,548,548,2,true,true,true,-1.0
2,2,0.5,0.5,false,false,300,250,798,298,498,48,2,true,true,true,-1.0
2,2,0.5,0.5,false,false,200,250,298,298,98,48,2,true,true,true,-1.0
2,2,0.5,0.5,false,false,250,300,298,798,48,498,2,true,true,true,-1.0
2,2,0.5,0.5,false,false,250,200,249,199,-1,-1,1,true,true,true,-1.0
2,2,0.5,0.5,false,false,200,250,299,849,99,599,1,true,true,true,-1.0
2,2,0.5,0.5,false,false,850,200,849,199,-1,-1,1,true,true,true,-1.0
2,2,0.5,0.5,false,false,200,250,299,299,99,49,1,true,true,true,-1.0
2,2,0.5,0.5,false,false,350,850,349,849,-1,-1,1,true,true,true,-1.0
0,0,0.5,0.5,false,false,200,200,298,798,98,598,2,true,true,true,0.175
0,0,0.5,0.5,false,false,250,300,797,347,547,47,3,true,true,true,-1.0
0,0,0.5,0.5,false,false,300,850,297,847,-3,-3,3,true,true,true,-1.0
0,0,0.5,0.5,false,false,200,200,248,798,48,598,2,true,true,true,-1.0
0,0,0.5,0.5,false,false,300,300,797,397,497,97,3,true,true,true,-1.0
0,0,0.5,0.5,false,false,300,250,897,297,597,47,3,true,true,true,-1.0
0,0,0.5,0.5,false,false,200,300,248,798,48,498,2,true,true,true,-1.0
0,0,0.5,0.5,false,false,900,250,896,246,-4,-4,4,true,true,true,-1.0
0,0,0.5,0.5,false,false,200,350,797,947,597,597,3,true,true,true,-1.0
0,0,0.5,0.5,false,false,300,350,296,346,-4,-4,4,true,true,true,-1.0
0,0,0.5,0.5,false,false,200,200,198,198,-2,-2,2,true,true,true,-1.0
0,0,0.5,0.5,false,false,300,300,297,297,-3,-3,3,true,true,true,-1.0
0,0,0.5,0.5,false,false,250,850,246,846,-4,-4,4,true,true,true,-1.0
0,0,0.5,0.5,false,false,300,300,296,296,-4,-4,4,true,true,true,-1.0
0,0,0.5,0.5,false,false,900,850,898,848,-2,-2,2,true,true,true,-1.0
0,0,0.5,0.5,false,false,900,300,896,296,-4,-4,4,true,true,true,-1.0
0,0,0.5,0.5,false,false,850,300,848,298,-2,-2,2,true,true,true,-1.0
0,0,0.5,0.5,false,false,900,850,898,848,-2,-2,2,true,true,true,-1.0
0,0,0.5,0.5,false,false,200,200,348,898,148,698,2,true,true,true,-1.0
0,0,0.5,0.5,false,false,250,900,247,897,-3,-3,3,true,true,true,-1.0
0,1,0.5,0.5,false,false,300,850,799,899,499,49,1,true,true,true,0.262
0,1,0.5,0.5,false,false,300,200,348,798,48,598,2,true,true,true,-1.0
0,1,0.5,0.5,false,false,300,850,297,847,-3,-3,3,true,true,true,-1.0
0,1,0.5,0.5,false,false,250,200,297,247,47,47,3,true,true,true,-1.0
0,1,0.5,0.5,false,false,850,850,849,849,-1,-1,1,true,true,true,-1.0
0,1,0.5,0.5,false,false,850,350,846,346,-4,-4,4,true,true,true,-1.0
0,1,0.5,0.5,false,false,250,300,246,296,-4,-4,4,true,true,true,-1.0
0,1,0.5,0.5,false,false,300,850,798,898,498,48,2,true,true,true,-1.0
0,1,0.5,0.5,false,false,250,300,249,299,-1,-1,1,true,true,true,-1.0
0,1,0.5,0.5,false,false,250,200,249,199,-1,-1,1,true,true,true,-1.0
0,1,0.5,0.5,false,false,350,300,346,296,-4,-4,4,true,true,true,-1.0
0,1,0.5,0.5,false,false,250,850,249,849,-1,-1,1,true,true,true,-1.0
0,1,0.5,0.5,false,false,300,200,296,196,-4,-4,4,true,true,true,-1.0
0,1,0.5,0.5,false,false,350,300,346,296,-4,-4,4,true,true,true,-1.0
0,1,0.5,0.5,false,false,250,300,348,798,98,498,2,true,true,true,-1.0
0,1,0.5,0.5,false,false,300,850,296,846,-4,-4,4,true,true,true,-1.0
0,1,0.5,0.5,false,false,850,300,846,296,-4,-4,4,true,true,true,-1.0
0,1,0.5,0.5,false,false,300,300,296,296,-4,-4,4,true,true,true,-1.0
0,1,0.5,0.5,false,false,850,850,846,846,-4,-4,4,true,true,true,-1.0
0,1,0.5,0.5,false,false,250,200,246,196,-4,-4,4,true,true,true,-1.0
0,2,0.5,0.5,false,true,300,300,348,898,48,598,2,true,true,true,310.681
0,2,0.5,0.5,false,true,250,200,348,798,98,598,2,true,true,true,-1.0
0,2,0.5,0.5,false,true,850,200,898,798,48,598,2,true,true,true,-1.0
0,2,0.5,0.5,false,true,300,350,298,348,-2,-2,2,true,true,true,-1.0
0,2,0.5,0.5,false,true,350,850,347,847,-3,-3,3,true,true,true,-1.0
0,2,0.5,0.5,false,true,350,250,346,246,-4,-4,4,true,true,true,-1.0
0,2,0.5,0.5,false,true,350,850,346,846,-4,-4,4,true,true,true,-1.0
0,2,0.5,0.5,false,true,200,200,196,196,-4,-4,4,true,true,true,-1.0
0,2,0.5,0.5,false,true,850,200,848,198,-2,-2,2,true,true,true,-1.0
0,2,0.5,0.5,false,true,300,300,947,797,647,497,3,true,true,true,-1.0
0,2,0.5,0.5,false,true,850,250,846,246,-4,-4,4,true,true,true,-1.0
0,2,0.5,0.5,false,true,300,250,798,898,498,648,2,true,true,true,-1.0
0,2,0.5,0.5,false,true,300,200,298,198,-2,-2,2,true,true,true,-1.0
0,2,0.5,0.5,false,true,300,250,347,797,47,547,3,true,true,true,-1.0
0,2,0.5,0.5,false,true,250,250,247,247,-3,-3,3,true,true,true,-1.0
0,2,0.5,0.5,false,true,850,900,846,896,-4,-4,4,true,true,true,-1.0
0,2,0.5,0.5,false,true,300,200,296,196,-4,-4,4,true,true,true,-1.0
0,2,0.5,0.5,false,true,300,300,348,798,48,498,2,true,true,true,-1.0
0,2,0.5,0.5,false,true,250,300,246,296,-4,-4,4,false,false,false,-1.0
0,2,0.5,0.5,false,true,250,250,298,798,48,548,2,true,true,true,-1.0
0,2,0.5,0.5,false,false,850,300,846,296,-4,-4,4,true,true,true,62.959
0,2,0.5,0.5,false,false,300,300,296,296,-4,-4,4,true,true,true,-1.0
0,2,0.5,0.5,false,false,300,350,298,348,-2,-2,2,true,true,true,-1.0
0,2,0.5,0.5,false,false,250,350,249,349,-1,-1,1,true,true,true,-1.0
0,2,0.5,0.5,false,false,300,850,297,847,-3,-3,3,true,true,true,-1.0
0,2,0.5,0.5,false,false,300,200,797,247,497,47,3,true,true,true,-1.0
0,2,0.5,0.5,false,false,250,300,797,897,547,597,3,true,true,true,-1.0
0,2,0.5,0.5,false,false,300,300,799,349,499,49,1,true,true,true,-1.0
0,2,0.5,0.5,false,false,300,350,297,347,-3,-3,3,true,true,true,-1.0
0,2,0.5,0.5,false,false,250,300,298,798,48,498,2,true,false,true,-1.0
0,2,0.5,0.5,false,false,300,300,299,299,-1,-1,1,true,true,true,-1.0
0,2,0.5,0.5,false,false,200,250,196,246,-4,-4,4,false,false,false,-1.0
0,2,0.5,0.5,false,false,300,850,297,847,-3,-3,3,true,true,true,-1.0
0,2,0.5,0.5,false,false,300,300,296,296,-4,-4,4,true,true,true,-1.0
0,2,0.5,0.5,false,false,300,350,299,349,-1,-1,1,true,true,true,-1.0
0,2,0.5,0.5,false,false,300,250,348,298,48,48,2,true,true,true,-1.0
0,2,0.5,0.5,false,false,250,300,298,848,48,548,2,true,false,true,-1.0
0,2,0.5,0.5,false,false,250,250,298,798,48,548,2,true,false,true,-1.0
0,2,0.5,0.5,false,false,300,350,299,349,-1,-1,1,true,true,true,-1.0
0,2,0.5,0.5,false,false,350,250,346,246,-4,-4,4,true,true,true,-1.0
1,0,0.5,0.5,false,false,200,200,249,249,49,49,1,true,false,true,0.293
1,0,0.5,0.5,false,false,300,250,300,250,0,0,0,true,true,true,-1.0
1,0,0.5,0.5,false,false,850,200,850,200,0,0,0,true,true,true,-1.0
1,0,0.5,0.5,false,false,850,250,850,250,0,0,0,true,true,true,-1.0
1,0,0.5,0.5,false,false,200,250,299,849,99,599,1,true,true,true,-1.0
1,0,0.5,0.5,false,false,300,200,297,197,-3,-3,3,true,true,true,-1.0
1,0,0.5,0.5,false,false,900,250,895,245,-5,-5,5,true,true,true,-1.0
1,0,0.5,0.5,false,false,850,300,847,297,-3,-3,3,true,true,true,-1.0
1,0,0.5,0.5,false,false,850,300,845,295,-5,-5,5,true,true,true,-1.0
1,0,0.5,0.5,false,false,250,250,299,799,49,549,1,true,true,true,-1.0
1,0,0.5,0.5,false,false,300,300,300,300,0,0,0,true,true,true,-1.0
1,0,0.5,0.5,false,false,250,300,797,347,547,47,3,true,true,true,-1.0
1,0,0.5,0.5,false,false,850,850,847,847,-3,-3,3,true,true,true,-1.0
1,0,0.5,0.5,false,false,250,300,245,295,-5,-5,5,false,false,false,-1.0
1,0,0.5,0.5,false,false,300,350,795,395,495,45,5,true,true,true,-1.0
1,0,0.5,0.5,false,false,200,200,246,246,46,46,4,true,true,true,-1.0
1,0,0.5,0.5,false,false,350,200,350,200,0,0,0,true,true,true,-1.0
1,0,0.5,0.5,false,false,850,200,845,195,-5,-5,5,true,true,true,-1.0
1,0,0.5,0.5,false,false,250,850,799,899,549,49,1,true,true,true,-1.0
1,0,0.5,0.5,false,false,300,300,797,347,497,47,3,true,true,true,-1.0
1,1,0.5,0.5,false,false,250,250,849,849,599,599,1,true,true,true,1.441
1,1,0.5,0.5,false,false,850,200,800,150,-50,-50,50,false,false,false,-1.0
1,1,0.5,0.5,false,false,250,250,200,200,-50,-50,50,true,true,true,-1.0
1,1,0.5,0.5,false,false,250,850,798,898,548,48,2,true,true,true,-1.0
1,1,0.5,0.5,false,false,850,900,800,850,-50,-50,50,true,true,true,-1.0
1,1,0.5,0.5,false,false,300,850,799,899,499,49,1,true,true,true,-1.0
1,1,0.5,0.5,false,false,250,300,799,949,549,649,1,true,true,true,-1.0
1,1,0.5,0.5,false,false,850,850,850,850,0,0,0,true,true,true,-1.0
1,1,0.5,0.5,false,false,300,250,849,849,549,599,1,true,true,true,-1.0
1,1,0.5,0.5,false,false,300,350,297,347,-3,-3,3,true,true,true,-1.0
1,1,0.5,0.5,false,false,850,900,800,850,-50,-50,50,true,true,true,-1.0
1,1,0.5,0.5,false,false,250,200,200,150,-50,-50,50,false,false,false,-1.0
1,1,0.5,0.5,false,false,300,300,349,799,49,499,1,true,true,true,-1.0
1,1,0.5,0.5,false,false,250,300,250,300,0,0,0,true,true,true,-1.0
1,1,0.5,0.5,false,false,200,300,200,300,0,0,0,true,true,true,-1.0
1,1,0.5,0.5,false,false,300,300,250,250,-50,-50,50,true,true,true,-1.0
1,1,0.5,0.5,false,false,300,300,250,250,-50,-50,50,false,false,false,-1.0
1,1,0.5,0.5,false,false,250,300,200,250,-50,-50,50,true,true,true,-1.0
1,1,0.5,0.5,false,false,250,250,799,349,549,99,1,true,true,true,-1.0
1,1,0.5,0.5,false,false,850,300,850,300,0,0,0,true,true,true,-1.0
1,2,0.5,0.5,false,true,250,850,249,849,-1,-1,1,true,true,true,333.282
1,2,0.5,0.5,false,true,350,250,350,250,0,0,0,true,true,true,-1.0
1,2,0.5,0.5,false,true,850,300,848,298,-2,-2,2,true,true,true,-1.0
1,2,0.5,0.5,false,true,250,300,249,299,-1,-1,1,true,true,true,-1.0
1,2,0.5,0.5,false,true,200,300,249,799,49,499,1,true,true,true,-1.0
1,2,0.5,0.5,false,true,200,300,799,899,599,599,1,true,true,true,-1.0
1,2,0.5,0.5,false,true,300,300,250,250,-50,-50,50,false,false,false,-1.0
1,2,0.5,0.5,false,true,850,300,850,300,0,0,0,true,true,true,-1.0
1,2,0.5,0.5,false,true,300,300,298,298,-2,-2,2,true,true,true,-1.0
1,2,0.5,0.5,false,true,250,300,250,300,0,0,0,true,true,true,-1.0
1,2,0.5,0.5,false,true,300,300,300,300,0,0,0,true,true,true,-1.0
1,2,0.5,0.5,false,true,200,250,198,248,-2,-2,2,true,true,true,-1.0
1,2,0.5,0.5,false,true,900,850,898,848,-2,-2,2,true,true,true,-1.0
1,2,0.5,0.5,false,true,900,200,898,198,-2,-2,2,true,true,true,-1.0
1,2,0.5,0.5,false,true,200,300,248,798,48,498,2,true,true,true,-1.0
1,2,0.5,0.5,false,true,200,250,949,799,749,549,1,true,true,true,-1.0
1,2,0.5,0.5,false,true,300,850,300,850,0,0,0,false,false,false,-1.0
1,2,0.5,0.5,false,true,300,250,349,799,49,549,1,true,true,true,-1.0
1,2,0.5,0.5,false,true,250,350,248,348,-2,-2,2,true,true,true,-1.0
1,2,0.5,0.5,false,true,200,850,298,898,98,48,2,true,true,true,-1.0
1,2,0.5,0.5,false,false,250,850,249,849,-1,-1,1,true,true,true,100.249
1,2,0.5,0.5,false,false,200,200,198,198,-2,-2,2,true,true,true,-1.0
1,2,0.5,0.5,false,false,250,850,248,848,-2,-2,2,true,true,true,-1.0
1,2,0.5,0.5,false,false,250,300,248,298,-2,-2,2,true,true,true,-1.0
1,2,0.5,0.5,false,false,250,850,248,848,-2,-2,2,true,true,true,-1.0
1,2,0.5,0.5,false,false,250,300,298,798,48,498,2,true,true,true,-1.0
1,2,0.5,0.5,false,false,850,300,899,799,49,499,1,true,true,true,-1.0
1,2,0.5,0.5,false,false,850,250,800,200,-50,-50,50,false,false,false,-1.0
1,2,0.5,0.5,false,false,350,300,350,300,0,0,0,true,true,true,-1.0
1,2,0.5,0.5,false,false,300,300,348,798,48,498,2,true,true,true,-1.0
1,2,0.5,0.5,false,false,300,250,796,296,496,46,4,true,true,true,-1.0
1,2,0.5,0.5,false,false,300,300,298,298,-2,-2,2,true,true,true,-1.0
1,2,0.5,0.5,false,false,250,250,349,799,99,549,1,true,true,true,-1.0
1,2,0.5,0.5,false,false,200,850,298,898,98,48,2,true,true,true,-1.0
1,2,0.5,0.5,false,false,850,250,899,799,49,549,1,true,true,true,-1.0
1,2,0.5,0.5,false,false,850,250,850,250,0,0,0,true,true,true,-1.0
1,2,0.5,0.5,false,false,200,250,297,297,97,47,3,true,true,true,-1.0
1,2,0.5,0.5,false,false,300,250,296,246,-4,-4,4,true,true,true,-1.0
1,2,0.5,0.5,false,false,300,300,799,399,499,99,1,true,true,true,-1.0
1,2,0.5,0.5,false,false,200,250,248,298,48,48,2,true,true,true,-1.0
2,0,0.5,0.5,true,false,300,350,297,347,-3,-3,3,true,true,true,490.775
2,0,0.5,0.5,true,false,300,300,300,300,0,0,0,true,true,true,-1.0
2,0,0.5,0.5,true,false,200,250,197,247,-3,-3,3,true,true,true,-1.0
2,0,0.5,0.5,true,false,850,200,850,200,0,0,0,true,true,true,-1.0
2,0,0.5,0.5,true,false,300,200,799,899,499,699,1,true,true,true,-1.0
2,0,0.5,0.5,true,false,300,200,897,347,597,147,3,true,true,true,-1.0
2,0,0.5,0.5,true,false,850,300,850,300,0,0,0,true,true,true,-1.0
2,0,0.5,0.5,true,false,250,850,247,847,-3,-3,3,true,true,true,-1.0
2,0,0.5,0.5,true,false,250,300,247,297,-3,-3,3,false,false,false,-1.0
2,0,0.5,0.5,true,false,350,200,345,195,-5,-5,5,true,true,true,-1.0
2,0,0.5,0.5,true,false,200,850,197,847,-3,-3,3,true,true,true,-1.0
2,0,0.5,0.5,true,false,300,300,797,897,497,597,3,true,true,true,-1.0
2,0,0.5,0.5,true,false,200,250,797,297,597,47,3,true,true,true,-1.0
2,0,0.5,0.5,true,false,200,350,197,347,-3,-3,3,true,true,true,-1.0
2,0,0.5,0.5,true,false,250,300,795,345,545,45,5,true,true,true,-1.0
2,0,0.5,0.5,true,false,350,200,897,247,547,47,3,true,true,true,-1.0
2,0,0.5,0.5,true,false,850,250,850,250,0,0,0,true,true,true,-1.0
2,0,0.5,0.5,true,false,250,200,297,247,47,47,3,true,true,true,-1.0
2,0,0.5,0.5,true,false,850,200,897,247,47,47,3,true,true,true,-1.0
2,0,0.5,0.5,true,false,250,850,247,847,-3,-3,3,true,true,true,-1.0
2,0,0.5,0.5,false,false,300,850,799,899,499,49,1,true,true,true,85.851
2,0,0.5,0.5,false,false,200,250,197,247,-3,-3,3,false,false,false,-1.0
2,0,0.5,0.5,false,false,200,250,897,297,697,47,3,true,true,true,-1.0
2,0,0.5,0.5,false,false,200,300,197,297,-3,-3,3,false,false,false,-1.0
2,0,0.5,0.5,false,false,300,350,797,397,497,47,3,true,true,true,-1.0
2,0,0.5,0.5,false,false,300,300,797,347,497,47,3,true,true,true,-1.0
2,0,0.5,0.5,false,false,250,250,245,245,-5,-5,5,true,true,true,-1.0
2,0,0.5,0.5,false,false,850,850,850,850,0,0,0,true,true,true,-1.0
2,0,0.5,0.5,false,false,250,300,247,297,-3,-3,3,true,true,true,-1.0
2,0,0.5,0.5,false,false,200,300,797,347,597,47,3,true,true,true,-1.0
2,0,0.5,0.5,false,false,350,250,345,245,-5,-5,5,true,true,true,-1.0
2,0,0.5,0.5,false,false,250,300,250,300,0,0,0,true,true,true,-1.0
2,0,0.5,0.5,false,false,250,300,298,798,48,498,2,true,true,true,-1.0
2,0,0.5,0.5,false,false,250,250,797,347,547,97,3,true,true,true,-1.0
2,0,0.5,0.5,false,false,850,200,850,200,0,0,0,true,true,true,-1.0
2,0,0.5,0.5,false,false,200,200,195,195,-5,-5,5,true,true,true,-1.0
2,0,0.5,0.5,false,false,850,350,850,350,0,0,0,true,true,true,-1.0
2,0,0.5,0.5,false,false,300,300,300,300,0,0,0,true,true,true,-1.0
2,0,0.5,0.5,false,false,300,850,797,897,497,47,3,true,true,true,-1.0
2,0,0.5,0.5,false,false,850,200,850,200,0,0,0,true,true,true,-1.0
2,1,0.5,0.5,true,false,250,250,798,898,548,648,2,true,true,true,1019.221
2,1,0.5,0.5,true,false,300,300,295,295,-5,-5,5,true,true,true,-1.0
2,1,0.5,0.5,true,false,200,250,797,897,597,647,3,true,true,true,-1.0
2,1,0.5,0.5,true,false,850,300,847,297,-3,-3,3,true,true,true,-1.0
2,1,0.5,0.5,true,false,250,350,846,896,596,546,4,true,true,true,-1.0
2,1,0.5,0.5,true,false,250,250,299,799,49,549,1,true,true,true,-1.0
2,1,0.5,0.5,true,false,250,200,399,249,149,49,1,true,true,true,-1.0
2,1,0.5,0.5,true,false,350,250,347,247,-3,-3,3,true,true,true,-1.0
2,1,0.5,0.5,true,false,300,300,348,798,48,498,2,true,true,true,-1.0
2,1,0.5,0.5,true,false,300,300,297,297,-3,-3,3,true,true,true,-1.0
2,1,0.5,0.5,true,false,250,200,250,200,0,0,0,true,true,true,-1.0
2,1,0.5,0.5,true,false,300,300,297,297,-3,-3,3,true,true,true,-1.0
2,1,0.5,0.5,true,false,250,250,247,247,-3,-3,3,true,true,true,-1.0
2,1,0.5,0.5,true,false,200,200,200,200,0,0,0,true,true,true,-1.0
2,1,0.5,0.5,true,false,200,300,249,799,49,499,1,true,true,true,-1.0
2,1,0.5,0.5,true,false,850,200,847,197,-3,-3,3,true,true,true,-1.0
2,1,0.5,0.5,true,false,250,250,250,250,0,0,0,true,true,true,-1.0
2,1,0.5,0.5,true,false,200,250,299,299,99,49,1,true,true,true,-1.0
2,1,0.5,0.5,true,false,250,300,247,297,-3,-3,3,true,true,true,-1.0
2,1,0.5,0.5,true,false,250,200,247,197,-3,-3,3,true,true,true,-1.0
2,1,0.5,0.5,false,false,200,300,248,348,48,48,2,true,true,true,137.511
2,1,0.5,0.5,false,false,850,350,847,347,-3,-3,3,true,true,true,-1.0
2,1,0.5,0.5,false,false,850,200,850,200,0,0,0,true,true,true,-1.0
2,1,0.5,0.5,false,false,250,300,247,297,-3,-3,3,true,true,true,-1.0
2,1,0.5,0.5,false,false,350,300,899,849,549,549,1,true,true,true,-1.0
2,1,0.5,0.5,false,false,350,850,347,847,-3,-3,3,true,true,true,-1.0
2,1,0.5,0.5,false,false,300,300,898,848,598,548,2,true,true,true,-1.0
2,1,0.5,0.5,false,false,200,850,150,800,-50,-50,50,false,false,false,-1.0
2,1,0.5,0.5,false,false,250,350,225,325,-25,-25,25,true,true,true,-1.0
2,1,0.5,0.5,false,false,300,300,297,297,-3,-3,3,true,true,true,-1.0
2,1,0.5,0.5,false,false,300,200,348,798,48,598,2,true,true,true,-1.0
2,1,0.5,0.5,false,false,250,300,798,898,548,598,2,true,true,true,-1.0
2,1,0.5,0.5,false,false,300,250,250,200,-50,-50,50,false,false,false,-1.0
2,1,0.5,0.5,false,false,250,250,298,798,48,548,2,true,true,true,-1.0
2,1,0.5,0.5,false,false,300,350,298,348,-2,-2,2,true,true,true,-1.0
2,1,0.5,0.5,false,false,200,250,150,200,-50,-50,50,false,false,false,-1.0
2,1,0.5,0.5,false,false,850,850,847,847,-3,-3,3,true,true,true,-1.0
2,1,0.5,0.5,false,false,300,200,897,247,597,47,3,true,true,true,-1.0
2,1,0.5,0.5,false,false,300,300,299,799,-1,499,1,true,true,true,-1.0
2,1,0.5,0.5,false,false,200,900,150,850,-50,-50,50,true,true,true,-1.0
2,2,0.5,0.5,true,true,300,200,848,848,548,648,2,true,true,true,865.581
2,2,0.5,0.5,true,true,850,850,849,849,-1,-1,1,true,true,true,-1.0
2,2,0.5,0.5,true,true,250,250,297,797,47,547,3,true,true,true,-1.0
2,2,0.5,0.5,true,true,200,200,199,199,-1,-1,1,true,true,true,-1.0
2,2,0.5,0.5,true,true,250,300,249,299,-1,-1,1,true,true,true,-1.0
2,2,0.5,0.5,true,true,250,300,246,296,-4,-4,4,true,true,true,-1.0
2,2,0.5,0.5,true,true,300,250,897,797,597,547,3,true,true,true,-1.0
2,2,0.5,0.5,true,true,300,350,899,899,599,549,1,true,true,true,-1.0
2,2,0.5,0.5,true,true,850,200,849,199,-1,-1,1,true,true,true,-1.0
2,2,0.5,0.5,true,true,200,200,298,898,98,698,2,true,true,true,-1.0
2,2,0.5,0.5,true,true,200,200,797,347,597,147,3,true,true,true,-1.0
2,2,0.5,0.5,true,true,250,250,248,248,-2,-2,2,true,true,true,-1.0
2,2,0.5,0.5,true,true,250,300,248,298,-2,-2,2,true,true,true,-1.0
2,2,0.5,0.5,true,true,250,300,249,299,-1,-1,1,true,true,true,-1.0
2,2,0.5,0.5,true,true,850,300,849,299,-1,-1,1,true,true,true,-1.0
2,2,0.5,0.5,true,true,250,850,249,849,-1,-1,1,true,true,true,-1.0
2,2,0.5,0.5,true,true,300,250,849,849,549,599,1,true,true,true,-1.0
2,2,0.5,0.5,true,true,850,900,849,899,-1,-1,1,true,true,true,-1.0
2,2,0.5,0.5,true,true,200,850,200,850,0,0,0,true,true,true,-1.0
2,2,0.5,0.5,true,true,300,850,299,849,-1,-1,1,true,true,true,-1.0
2,2,0.5,0.5,true,false,200,250,799,799,599,549,1,true,true,true,485.522
2,2,0.5,0.5,true,false,300,250,299,249,-1,-1,1,true,true,true,-1.0
2,2,0.5,0.5,true,false,300,250,899,299,599,49,1,true,true,true,-1.0
2,2,0.5,0.5,true,false,850,250,849,249,-1,-1,1,true,true,true,-1.0
2,2,0.5,0.5,true,false,300,250,300,250,0,0,0,true,true,true,-1.0
2,2,0.5,0.5,true,false,250,300,249,299,-1,-1,1,true,true,true,-1.0
2,2,0.5,0.5,true,false,850,300,899,799,49,499,1,true,true,true,-1.0
2,2,0.5,0.5,true,false,200,200,200,200,0,0,0,true,true,true,-1.0
2,2,0.5,0.5,true,false,350,300,346,296,-4,-4,4,true,true,true,-1.0
2,2,0.5,0.5,true,false,300,250,348,798,48,548,2,true,true,true,-1.0
2,2,0.5,0.5,true,false,250,350,247,347,-3,-3,3,true,true,true,-1.0
2,2,0.5,0.5,true,false,250,300,247,297,-3,-3,3,true,true,true,-1.0
2,2,0.5,0.5,true,false,300,350,298,348,-2,-2,2,true,true,true,-1.0
2,2,0.5,0.5,true,false,250,300,846,846,596,546,4,true,true,true,-1.0
2,2,0.5,0.5,true,false,300,300,300,300,0,0,0,true,true,true,-1.0
2,2,0.5,0.5,true,false,300,350,299,349,-1,-1,1,true,true,true,-1.0
2,2,0.5,0.5,true,false,250,850,798,898,548,48,2,true,true,true,-1.0
2,2,0.5,0.5,true,false,300,300,299,299,-1,-1,1,true,true,true,-1.0
2,2,0.5,0.5,true,false,850,250,849,249,-1,-1,1,true,true,true,-1.0
2,2,0.5,0.5,true,false,250,300,348,798,98,498,2,true,true,true,-1.0
2,2,0.5,0.5,false,true,250,250,798,798,548,548,2,true,true,true,151.795
2,2,0.5,0.5,false,true,300,200,349,249,49,49,1,true,true,true,-1.0
2,2,0.5,0.5,false,true,350,250,348,248,-2,-2,2,true,true,true,-1.0
2,2,0.5,0.5,false,true,850,200,847,247,-3,47,3,true,true,true,-1.0
2,2,0.5,0.5,false,true,250,850,249,849,-1,-1,1,true,true,true,-1.0
2,2,0.5,0.5,false,true,250,200,298,798,48,598,2,true,true,true,-1.0
2,2,0.5,0.5,false,true,850,300,899,799,49,499,1,true,true,true,-1.0
2,2,0.5,0.5,false,true,200,850,248,898,48,48,2,true,true,true,-1.0
2,2,0.5,0.5,false,true,300,300,299,299,-1,-1,1,true,true,true,-1.0
2,2,0.5,0.5,false,true,250,200,799,299,549,99,1,true,true,true,-1.0
2,2,0.5,0.5,false,true,350,250,948,798,598,548,2,true,true,true,-1.0
2,2,0.5,0.5,false,true,850,250,847,247,-3,-3,3,true,true,true,-1.0
2,2,0.5,0.5,false,true,200,250,249,799,49,549,1,true,true,true,-1.0
2,2,0.5,0.5,false,true,250,200,297,297,47,97,3,true,true,true,-1.0
2,2,0.5,0.5,false,true,850,350,849,349,-1,-1,1,true,true,true,-1.0
2,2,0.5,0.5,false,true,300,250,799,349,499,99,1,true,true,true,-1.0
2,2,0.5,0.5,false,true,300,300,298,298,-2,-2,2,true,true,true,-1.0
2,2,0.5,0.5,false,true,300,300,799,949,499,649,1,true,true,true,-1.0
2,2,0.5,0.5,false,true,200,200,200,200,0,0,0,true,true,true,-1.0
2,2,0.5,0.5,false,true,300,200,299,199,-1,-1,1,true,true,true,-1.0
2,2,0.5,0.5,false,false,850,850,849,849,-1,-1,1,true,true,true,87.119
2,2,0.5,0.5,false,false,850,300,898,798,48,498,2,true,true,true,-1.0
2,2,0.5,0.5,false,false,300,300,348,798,48,498,2,true,true,true,-1.0
2,2,0.5,0.5,false,false,200,250,249,299,49,49,1,true,true,true,-1.0
2,2,0.5,0.5,false,false,350,300,898,848,548,548,2,true,true,true,-1.0
2,2,0.5,0.5,false,false,200,900,298,948,98,48,2,true,true,true,-1.0
2,2,0.5,0.5,false,false,300,350,797,397,497,47,3,true,true,true,-1.0
2,2,0.5,0.5,false,false,300,300,299,299,-1,-1,1,true,true,true,-1.0
2,2,0.5,0.5,false,false,300,300,798,348,498,48,2,true,true,true,-1.0
2,2,0.5,0.5,false,false,250,850,249,849,-1,-1,1,true,true,true,-1.0
2,2,0.5,0.5,false,false,250,900,248,898,-2,-2,2,true,true,true,-1.0
2,2,0.5,0.5,false,false,850,300,849,299,-1,-1,1,true,true,true,-1.0
2,2,0.5,0.5,false,false,250,350,248,348,-2,-2,2,true,true,true,-1.0
2,2,0.5,0.5,false,false,350,350,349,349,-1,-1,1,true,true,true,-1.0
2,2,0.5,0.5,false,false,200,300,798,348,598,48,2,true,true,true,-1.0
2,2,0.5,0.5,false,false,850,300,849,299,-1,-1,1,true,true,true,-1.0
2,2,0.5,0.5,false,false,850,850,849,849,-1,-1,1,true,true,true,-1.0
2,2,0.5,0.5,false,false,350,250,349,249,-1,-1,1,true,true,true,-1.0
2,2,0.5,0.5,false,false,850,850,850,850,0,0,0,true,true,true,-1.0
2,2,0.5,0.5,false,false,300,250,299,249,-1,-1,1,true,true,true,-1.0
0,0,0.5,0.5,false,false,200,300,348,798,148,498,2,true,true,true,0.173
0,0,0.5,0.5,false,false,250,350,797,397,547,47,3,true,true,true,-1.0
0,0,0.5,0.5,false,false,250,850,799,899,549,49,1,true,true,true,-1.0
0,0,0.5,0.5,false,false,200,250,197,247,-3,-3,3,true,true,true,-1.0
0,0,0.5,0.5,false,false,300,200,799,249,499,49,1,true,true,true,-1.0
0,0,0.5,0.5,false,false,350,250,396,296,46,46,4,true,true,true,-1.0
0,0,0.5,0.5,false,false,250,850,247,847,-3,-3,3,true,true,true,-1.0
0,0,0.5,0.5,false,false,250,300,246,296,-4,-4,4,false,false,false,-1.0
0,0,0.5,0.5,false,false,300,850,297,847,-3,-3,3,true,true,true,-1.0
0,0,0.5,0.5,false,false,250,900,797,947,547,47,3,true,true,true,-1.0
0,0,0.5,0.5,false,false,300,300,348,798,48,498,2,true,true,true,-1.0
0,0,0.5,0.5,false,false,350,300,347,297,-3,-3,3,true,true,true,-1.0
0,0,0.5,0.5,false,false,250,850,247,847,-3,-3,3,true,true,true,-1.0
0,0,0.5,0.5,false,false,200,300,348,798,148,498,2,true,true,true,-1.0
0,0,0.5,0.5,false,false,250,300,248,298,-2,-2,2,true,true,true,-1.0
0,0,0.5,0.5,false,false,300,200,347,297,47,97,3,true,true,true,-1.0
0,0,0.5,0.5,false,false,300,250,799,349,499,99,1,true,true,true,-1.0
0,0,0.5,0.5,false,false,850,350,848,348,-2,-2,2,true,true,true,-1.0
0,0,0.5,0.5,false,false,300,350,797,397,497,47,3,true,true,true,-1.0
0,0,0.5,0.5,false,false,850,250,898,798,48,548,2,true,true,true,-1.0
0,1,0.5,0.5,false,false,300,300,797,347,497,47,3,true,true,true,0.294
0,1,0.5,0.5,false,false,250,850,247,847,-3,-3,3,true,true,true,-1.0
0,1,0.5,0.5,false,false,350,200,398,248,48,48,2,true,true,true,-1.0
0,1,0.5,0.5,false,false,350,200,899,849,549,649,1,true,true,true,-1.0
0,1,0.5,0.5,false,false,300,300,799,349,499,49,1,true,true,true,-1.0
0,1,0.5,0.5,false,false,850,250,898,798,48,548,2,true,true,true,-1.0
0,1,0.5,0.5,false,false,250,900,797,947,547,47,3,true,true,true,-1.0
0,1,0.5,0.5,false,false,350,350,347,347,-3,-3,3,true,true,true,-1.0
0,1,0.5,0.5,false,false,850,300,846,296,-4,-4,4,true,true,true,-1.0
0,1,0.5,0.5,false,false,250,300,348,798,98,498,2,true,true,true,-1.0
0,1,0.5,0.5,false,false,200,200,196,196,-4,-4,4,true,true,true,-1.0
0,1,0.5,0.5,false,false,300,200,296,196,-4,-4,4,false,false,false,-1.0
0,1,0.5,0.5,false,false,300,900,299,899,-1,-1,1,true,true,true,-1.0
0,1,0.5,0.5,false,false,900,300,898,298,-2,-2,2,true,true,true,-1.0
0,1,0.5,0.5,false,false,250,850,247,847,-3,-3,3,true,true,true,-1.0
0,1,0.5,0.5,false,false,300,350,297,347,-3,-3,3,true,true,true,-1.0
0,1,0.5,0.5,false,false,250,300,246,296,-4,-4,4,true,true,true,-1.0
0,1,0.5,0.5,false,false,200,300,197,297,-3,-3,3,true,true,true,-1.0
0,1,0.5,0.5,false,false,300,250,797,347,497,97,3,true,true,true,-1.0
0,1,0.5,0.5,false,false,300,200,296,196,-4,-4,4,true,true,true,-1.0
0,2,0.5,0.5,false,true,850,850,849,849,-1,-1,1,true,true,true,313.527
0,2,0.5,0.5,false,true,900,200,898,198,-2,-2,2,true,true,true,-1.0
0,2,0.5,0.5,false,true,250,300,298,898,48,598,2,true,true,true,-1.0
0,2,0.5,0.5,false,true,300,350,797,397,497,47,3,true,true,true,-1.0
0,2,0.5,0.5,false,true,200,300,298,798,98,498,2,true,true,true,-1.0
0,2,0.5,0.5,false,true,850,300,846,296,-4,-4,4,true,true,true,-1.0
0,2,0.5,0.5,false,true,850,300,846,296,-4,-4,4,true,true,true,-1.0
0,2,0.5,0.5,false,true,300,200,296,196,-4,-4,4,true,true,true,-1.0
0,2,0.5,0.5,false,true,200,250,798,298,598,48,2,true,true,true,-1.0
0,2,0.5,0.5,false,true,250,850,247,847,-3,-3,3,true,true,true,-1.0
0,2,0.5,0.5,false,true,200,250,348,798,148,548,2,true,true,true,-1.0
0,2,0.5,0.5,false,true,350,300,346,296,-4,-4,4,true,true,true,-1.0
0,2,0.5,0.5,false,true,200,850,199,849,-1,-1,1,true,true,true,-1.0
0,2,0.5,0.5,false,true,300,200,799,299,499,99,1,true,true,true,-1.0
0,2,0.5,0.5,false,true,300,250,296,246,-4,-4,4,true,true,true,-1.0
0,2,0.5,0.5,false,true,850,250,846,246,-4,-4,4,true,true,true,-1.0
0,2,0.5,0.5,false,true,300,250,799,299,499,49,1,true,true,true,-1.0
0,2,0.5,0.5,false,true,350,300,346,296,-4,-4,4,false,false,false,-1.0
0,2,0.5,0.5,false,true,850,250,846,246,-4,-4,4,true,true,true,-1.0
0,2,0.5,0.5,false,true,200,300,199,299,-1,-1,1,true,true,true,-1.0
0,2,0.5,0.5,false,false,300,300,296,296,-4,-4,4,true,true,true,57.167
0,2,0.5,0.5,false,false,300,250,296,246,-4,-4,4,true,true,true,-1.0
0,2,0.5,0.5,false,false,250,300,799,899,549,599,1,true,true,true,-1.0
0,2,0.5,0.5,false,false,350,850,349,849,-1,-1,1,true,true,true,-1.0
0,2,0.5,0.5,false,false,300,200,848,848,548,648,2,true,true,true,-1.0
0,2,0.5,0.5,false,false,200,850,248,898,48,48,2,true,true,true,-1.0
0,2,0.5,0.5,false,false,250,200,298,298,48,98,2,true,true,true,-1.0
0,2,0.5,0.5,false,false,250,200,248,198,-2,-2,2,true,true,true,-1.0
0,2,0.5,0.5,false,false,350,250,346,246,-4,-4,4,true,true,true,-1.0
0,2,0.5,0.5,false,false,200,300,199,299,-1,-1,1,true,true,true,-1.0
0,2,0.5,0.5,false,false,300,300,799,949,499,649,1,true,true,true,-1.0
0,2,0.5,0.5,false,false,250,250,298,798,48,548,2,true,true,true,-1.0
0,2,0.5,0.5,false,false,200,300,196,296,-4,-4,4,false,false,false,-1.0
0,2,0.5,0.5,false,false,200,250,246,296,46,46,4,true,true,true,-1.0
0,2,0.5,0.5,false,false,300,900,296,896,-4,-4,4,true,true,true,-1.0
0,2,0.5,0.5,false,false,200,250,196,246,-4,-4,4,false,false,false,-1.0
0,2,0.5,0.5,false,false,850,850,846,846,-4,-4,4,true,true,true,-1.0
0,2,0.5,0.5,false,false,250,250,246,246,-4,-4,4,true,true,true,-1.0
0,2,0.5,0.5,false,false,250,250,246,246,-4,-4,4,false,false,false,-1.0
0,2,0.5,0.5,false,false,350,850,346,846,-4,-4,4,true,true,true,-1.0
1,0,0.5,0.5,false,false,250,200,297,247,47,47,3,true,true,true,0.272
1,0,0.5,0.5,false,false,350,350,350,350,0,0,0,true,true,true,-1.0
1,0,0.5,0.5,false,false,300,300,297,297,-3,-3,3,true,true,true,-1.0
1,0,0.5,0.5,false,false,850,300,848,298,-2,-2,2,true,true,true,-1.0
1,0,0.5,0.5,false,false,300,850,799,899,499,49,1,true,true,true,-1.0
1,0,0.5,0.5,false,false,300,850,799,899,499,49,1,true,true,true,-1.0
1,0,0.5,0.5,false,false,850,350,845,345,-5,-5,5,true,true,true,-1.0
1,0,0.5,0.5,false,false,300,250,300,250,0,0,0,false,false,false,-1.0
1,0,0.5,0.5,false,false,350,350,347,347,-3,-3,3,true,true,true,-1.0
1,0,0.5,0.5,false,false,200,300,195,295,-5,-5,5,false,false,false,-1.0
1,0,0.5,0.5,false,false,350,300,399,799,49,499,1,true,true,true,-1.0
1,0,0.5,0.5,false,false,300,250,898,798,598,548,2,true,true,true,-1.0
1,0,0.5,0.5,false,false,850,300,850,300,0,0,0,true,true,true,-1.0
1,0,0.5,0.5,false,false,300,300,849,849,549,549,1,true,true,true,-1.0
1,0,0.5,0.5,false,false,300,850,297,847,-3,-3,3,true,true,true,-1.0
1,0,0.5,0.5,false,false,200,250,197,247,-3,-3,3,true,true,true,-1.0
1,0,0.5,0.5,false,false,200,250,247,297,47,47,3,true,true,true,-1.0
1,0,0.5,0.5,false,false,200,250,248,798,48,548,2,true,true,true,-1.0
1,0,0.5,0.5,false,false,250,250,250,250,0,0,0,true,true,true,-1.0
1,0,0.5,0.5,false,false,300,300,898,798,598,498,2,true,true,true,-1.0
1,1,0.5,0.5,false,false,200,200,150,150,-50,-50,50,false,false,false,1.172
1,1,0.5,0.5,false,false,850,300,800,250,-50,-50,50,true,true,true,-1.0
1,1,0.5,0.5,false,false,850,200,848,198,-2,-2,2,true,true,true,-1.0
1,1,0.5,0.5,false,false,250,200,200,150,-50,-50,50,false,false,false,-1.0
1,1,0.5,0.5,false,false,900,250,900,250,0,0,0,true,true,true,-1.0
1,1,0.5,0.5,false,false,300,300,799,899,499,599,1,true,true,true,-1.0
1,1,0.5,0.5,false,false,300,300,799,349,499,49,1,true,true,true,-1.0
1,1,0.5,0.5,false,false,200,250,150,200,-50,-50,50,false,false,false,-1.0
1,1,0.5,0.5,false,false,300,350,250,300,-50,-50,50,true,true,true,-1.0
1,1,0.5,0.5,false,false,300,200,300,200,0,0,0,true,true,true,-1.0
1,1,0.5,0.5,false,false,350,300,350,300,0,0,0,true,true,true,-1.0
1,1,0.5,0.5,false,false,850,300,800,250,-50,-50,50,true,true,true,-1.0
1,1,0.5,0.5,false,false,300,200,250,150,-50,-50,50,false,false,false,-1.0
1,1,0.5,0.5,false,false,250,200,200,150,-50,-50,50,false,false,false,-1.0
1,1,0.5,0.5,false,false,850,250,800,200,-50,-50,50,true,true,true,-1.0
1,1,0.5,0.5,false,false,850,300,850,300,0,0,0,true,true,true,-1.0
1,1,0.5,0.5,false,false,250,300,250,300,0,0,0,true,true,true,-1.0
1,1,0.5,0.5,false,false,300,300,250,250,-50,-50,50,true,true,true,-1.0
1,1,0.5,0.5,false,false,300,250,250,200,-50,-50,50,false,false,false,-1.0
1,1,0.5,0.5,false,false,300,850,250,800,-50,-50,50,true,true,true,-1.0
1,2,0.5,0.5,false,true,250,850,248,848,-2,-2,2,true,true,true,567.183
1,2,0.5,0.5,false,true,200,350,197,347,-3,-3,3,true,true,true,-1.0
1,2,0.5,0.5,false,true,850,350,848,348,-2,-2,2,true,true,true,-1.0
1,2,0.5,0.5,false,true,300,300,298,298,-2,-2,2,true,true,true,-1.0
1,2,0.5,0.5,false,true,900,300,898,298,-2,-2,2,true,true,true,-1.0
1,2,0.5,0.5,false,true,300,200,849,349,549,149,1,true,true,true,-1.0
1,2,0.5,0.5,false,true,200,250,898,798,698,548,2,true,true,true,-1.0
1,2,0.5,0.5,false,true,250,300,248,298,-2,-2,2,true,true,true,-1.0
1,2,0.5,0.5,false,true,300,350,348,898,48,548,2,true,true,true,-1.0
1,2,0.5,0.5,false,true,250,300,898,798,648,498,2,true,true,true,-1.0
1,2,0.5,0.5,false,true,250,300,250,300,0,0,0,true,true,true,-1.0
1,2,0.5,0.5,false,true,350,850,348,848,-2,-2,2,true,true,true,-1.0
1,2,0.5,0.5,false,true,200,250,200,250,0,0,0,true,true,true,-1.0
1,2,0.5,0.5,false,true,300,850,299,849,-1,-1,1,true,true,true,-1.0
1,2,0.5,0.5,false,true,250,850,248,848,-2,-2,2,true,true,true,-1.0
1,2,0.5,0.5,false,true,250,250,297,297,47,47,3,true,true,true,-1.0
1,2,0.5,0.5,false,true,300,200,799,399,499,199,1,true,true,true,-1.0
1,2,0.5,0.5,false,true,300,850,298,848,-2,-2,2,true,true,true,-1.0
1,2,0.5,0.5,false,true,300,250,347,297,47,47,3,true,true,true,-1.0
1,2,0.5,0.5,false,true,250,250,296,796,46,546,4,true,true,true,-1.0
1,2,0.5,0.5,false,false,250,250,298,948,48,698,2,true,true,true,107.098
1,2,0.5,0.5,false,false,200,850,199,849,-1,-1,1,true,true,true,-1.0
1,2,0.5,0.5,false,false,300,850,298,848,-2,-2,2,true,true,true,-1.0
1,2,0.5,0.5,false,false,300,900,299,899,-1,-1,1,true,true,true,-1.0
1,2,0.5,0.5,false,false,250,300,299,799,49,499,1,true,true,true,-1.0
1,2,0.5,0.5,false,false,850,300,850,300,0,0,0,true,true,true,-1.0
1,2,0.5,0.5,false,false,200,250,249,799,49,549,1,true,true,true,-1.0
1,2,0.5,0.5,false,false,250,250,247,297,-3,47,3,true,true,true,-1.0
1,2,0.5,0.5,false,false,200,350,198,348,-2,-2,2,true,true,true,-1.0
1,2,0.5,0.5,false,false,250,200,298,198,48,-2,2,true,false,true,-1.0
1,2,0.5,0.5,false,false,300,850,298,848,-2,-2,2,true,true,true,-1.0
1,2,0.5,0.5,false,false,900,850,900,850,0,0,0,true,true,true,-1.0
1,2,0.5,0.5,false,false,250,300,299,799,49,499,1,true,true,true,-1.0
1,2,0.5,0.5,false,false,850,300,849,299,-1,-1,1,true,true,true,-1.0
1,2,0.5,0.5,false,false,350,200,350,200,0,0,0,true,true,true,-1.0
1,2,0.5,0.5,false,false,850,250,850,250,0,0,0,true,true,true,-1.0
1,2,0.5,0.5,false,false,850,300,848,298,-2,-2,2,true,true,true,-1.0
1,2,0.5,0.5,false,false,200,300,249,799,49,499,1,true,true,true,-1.0
1,2,0.5,0.5,false,false,200,850,198,848,-2,-2,2,true,true,true,-1.0
1,2,0.5,0.5,false,false,300,350,348,898,48,548,2,true,true,true,-1.0
2,0,0.5,0.5,true,false,250,250,247,247,-3,-3,3,false,false,false,613.293
2,0,0.5,0.5,true,false,300,250,297,247,-3,-3,3,true,true,true,-1.0
2,0,0.5,0.5,true,false,300,300,300,300,0,0,0,true,true,true,-1.0
2,0,0.5,0.5,true,false,300,850,297,847,-3,-3,3,true,true,true,-1.0
2,0,0.5,0.5,true,false,200,300,197,297,-3,-3,3,true,true,true,-1.0
2,0,0.5,0.5,true,false,300,200,849,249,549,49,1,true,true,true,-1.0
2,0,0.5,0.5,true,false,250,300,846,346,596,46,4,true,true,true,-1.0
2,0,0.5,0.5,true,false,250,300,245,295,-5,-5,5,false,false,false,-1.0
2,0,0.5,0.5,true,false,350,300,946,796,596,496,4,true,true,true,-1.0
2,0,0.5,0.5,true,false,850,300,899,799,49,499,1,true,true,true,-1.0
2,0,0.5,0.5,true,false,250,850,247,847,-3,-3,3,false,false,false,-1.0
2,0,0.5,0.5,true,false,350,850,347,847,-3,-3,3,true,true,true,-1.0
2,0,0.5,0.5,true,false,300,250,797,347,497,97,3,true,true,true,-1.0
2,0,0.5,0.5,true,false,350,200,897,297,547,97,3,true,true,true,-1.0
2,0,0.5,0.5,true,false,250,200,797,247,547,47,3,true,false,true,-1.0
2,0,0.5,0.5,true,false,850,850,847,847,-3,-3,3,true,true,true,-1.0
2,0,0.5,0.5,true,false,850,300,845,295,-5,-5,5,true,true,true,-1.0
2,0,0.5,0.5,true,false,300,850,295,845,-5,-5,5,true,true,true,-1.0
2,0,0.5,0.5,true,false,200,250,197,247,-3,-3,3,true,true,true,-1.0
2,0,0.5,0.5,true,false,300,350,300,350,0,0,0,true,true,true,-1.0
2,0,0.5,0.5,false,false,250,850,247,847,-3,-3,3,true,true,true,89.546
2,0,0.5,0.5,false,false,300,300,300,300,0,0,0,false,false,false,-1.0
2,0,0.5,0.5,false,false,250,850,247,847,-3,-3,3,true,true,true,-1.0
2,0,0.5,0.5,false,false,300,900,297,897,-3,-3,3,true,true,true,-1.0
2,0,0.5,0.5,false,false,300,250,300,250,0,0,0,true,true,true,-1.0
2,0,0.5,0.5,false,false,850,850,847,847,-3,-3,3,true,true,true,-1.0
2,0,0.5,0.5,false,false,250,250,797,347,547,97,3,true,true,true,-1.0
2,0,0.5,0.5,false,false,250,250,245,245,-5,-5,5,true,true,true,-1.0
2,0,0.5,0.5,false,false,200,250,797,297,597,47,3,true,true,true,-1.0
2,0,0.5,0.5,false,false,300,300,295,295,-5,-5,5,true,true,true,-1.0
2,0,0.5,0.5,false,false,300,250,898,798,598,548,2,true,true,true,-1.0
2,0,0.5,0.5,false,false,250,850,247,847,-3,-3,3,false,false,false,-1.0
2,0,0.5,0.5,false,false,300,250,295,245,-5,-5,5,true,true,true,-1.0
2,0,0.5,0.5,false,false,300,850,297,847,-3,-3,3,true,true,true,-1.0
2,0,0.5,0.5,false,false,850,300,898,798,48,498,2,true,true,true,-1.0
2,0,0.5,0.5,false,false,250,900,247,897,-3,-3,3,true,true,true,-1.0
2,0,0.5,0.5,false,false,200,850,797,897,597,47,3,true,true,true,-1.0
2,0,0.5,0.5,false,false,300,850,295,845,-5,-5,5,true,true,true,-1.0
2,0,0.5,0.5,false,false,250,300,899,799,649,499,1,true,true,true,-1.0
2,0,0.5,0.5,false,false,200,250,797,297,597,47,3,true,true,true,-1.0
2,1,0.5,0.5,true,false,850,850,847,847,-3,-3,3,true,true,true,1396.66
2,1,0.5,0.5,true,false,200,250,249,299,49,49,1,true,true,true,-1.0
2,1,0.5,0.5,true,false,300,250,300,250,0,0,0,false,false,false,-1.0
2,1,0.5,0.5,true,false,850,850,850,850,0,0,0,true,true,true,-1.0
2,1,0.5,0.5,true,false,300,300,797,347,497,47,3,true,true,true,-1.0
2,1,0.5,0.5,true,false,300,850,297,847,-3,-3,3,true,true,true,-1.0
2,1,0.5,0.5,true,false,250,200,797,897,547,697,3,true,true,true,-1.0
2,1,0.5,0.5,true,false,850,350,847,347,-3,-3,3,true,true,true,-1.0
2,1,0.5,0.5,true,false,850,250,850,250,0,0,0,true,true,true,-1.0
2,1,0.5,0.5,true,false,350,250,396,796,46,546,4,true,true,true,-1.0
2,1,0.5,0.5,true,false,200,200,200,200,0,0,0,true,true,true,-1.0
2,1,0.5,0.5,true,false,200,850,197,847,-3,-3,3,true,true,true,-1.0
2,1,0.5,0.5,true,false,250,250,247,247,-3,-3,3,true,true,true,-1.0
2,1,0.5,0.5,true,false,200,850,197,847,-3,-3,3,true,true,true,-1.0
2,1,0.5,0.5,true,false,200,200,197,197,-3,-3,3,true,true,true,-1.0
2,1,0.5,0.5,true,false,250,200,847,247,597,47,3,true,false,true,-1.0
2,1,0.5,0.5,true,false,250,200,247,197,-3,-3,3,true,true,true,-1.0
2,1,0.5,0.5,true,false,250,350,247,347,-3,-3,3,true,true,true,-1.0
2,1,0.5,0.5,true,false,200,250,344,294,144,44,6,true,true,true,-1.0
2,1,0.5,0.5,true,false,250,300,796,346,546,46,4,true,true,true,-1.0
2,1,0.5,0.5,false,false,300,300,348,798,48,498,2,true,true,true,91.003
2,1,0.5,0.5,false,false,300,250,796,896,496,646,4,true,true,true,-1.0
2,1,0.5,0.5,false,false,200,250,191,241,-9,-9,9,true,true,true,-1.0
2,1,0.5,0.5,false,false,300,200,846,896,546,696,4,true,true,true,-1.0
2,1,0.5,0.5,false,false,850,850,847,847,-3,-3,3,true,true,true,-1.0
2,1,0.5,0.5,false,false,300,200,799,249,499,49,1,true,true,true,-1.0
2,1,0.5,0.5,false,false,200,300,249,799,49,499,1,true,true,true,-1.0
2,1,0.5,0.5,false,false,850,250,847,247,-3,-3,3,true,true,true,-1.0
2,1,0.5,0.5,false,false,200,200,799,249,599,49,1,true,true,true,-1.0
2,1,0.5,0.5,false,false,300,300,799,899,499,599,1,true,true,true,-1.0
2,1,0.5,0.5,false,false,250,200,773,373,523,173,27,true,true,true,-1.0
2,1,0.5,0.5,false,false,250,900,798,948,548,48,2,true,true,true,-1.0
2,1,0.5,0.5,false,false,200,300,248,798,48,498,2,true,true,true,-1.0
2,1,0.5,0.5,false,false,300,300,297,297,-3,-3,3,true,true,true,-1.0
2,1,0.5,0.5,false,false,300,250,348,798,48,548,2,true,true,true,-1.0
2,1,0.5,0.5,false,false,300,850,300,850,0,0,0,true,true,true,-1.0
2,1,0.5,0.5,false,false,350,300,398,798,48,498,2,true,true,true,-1.0
2,1,0.5,0.5,false,false,200,250,246,296,46,46,4,true,true,true,-1.0
2,1,0.5,0.5,false,false,850,250,847,247,-3,-3,3,true,true,true,-1.0
2,1,0.5,0.5,false,false,300,300,297,297,-3,-3,3,true,true,true,-1.0
2,2,0.5,0.5,true,true,300,300,300,300,0,0,0,true,true,true,643.37
2,2,0.5,0.5,true,true,850,850,850,850,0,0,0,true,true,true,-1.0
2,2,0.5,0.5,true,true,300,300,348,798,48,498,2,true,true,true,-1.0
2,2,0.5,0.5,true,true,300,200,298,198,-2,-2,2,true,true,true,-1.0
2,2,0.5,0.5,true,true,300,250,798,298,498,48,2,true,true,true,-1.0
2,2,0.5,0.5,true,true,850,200,898,248,48,48,2,true,true,true,-1.0
2,2,0.5,0.5,true,true,850,900,849,899,-1,-1,1,true,true,true,-1.0
2,2,0.5,0.5,true,true,300,300,798,348,498,48,2,true,true,true,-1.0
2,2,0.5,0.5,true,true,300,200,799,249,499,49,1,true,true,true,-1.0
2,2,0.5,0.5,true,true,350,200,399,249,49,49,1,true,true,true,-1.0
2,2,0.5,0.5,true,true,300,850,799,899,499,49,1,true,true,true,-1.0
2,2,0.5,0.5,true,true,300,200,300,200,0,0,0,true,true,true,-1.0
2,2,0.5,0.5,true,true,300,300,798,898,498,598,2,true,true,true,-1.0
2,2,0.5,0.5,true,true,250,200,799,249,549,49,1,true,true,true,-1.0
2,2,0.5,0.5,true,true,300,300,298,298,-2,-2,2,true,true,true,-1.0
2,2,0.5,0.5,true,true,250,850,799,899,549,49,1,true,true,true,-1.0
2,2,0.5,0.5,true,true,250,300,249,299,-1,-1,1,false,false,false,-1.0
2,2,0.5,0.5,true,true,300,300,300,300,0,0,0,true,true,true,-1.0
2,2,0.5,0.5,true,true,200,300,199,299,-1,-1,1,true,true,true,-1.0
2,2,0.5,0.5,true,true,850,350,849,349,-1,-1,1,true,true,true,-1.0
2,2,0.5,0.5,true,false,900,300,900,300,0,0,0,true,true,true,567.88
2,2,0.5,0.5,true,false,850,250,899,799,49,549,1,true,true,true,-1.0
2,2,0.5,0.5,true,false,300,850,299,849,-1,-1,1,true,true,true,-1.0
2,2,0.5,0.5,true,false,200,850,199,849,-1,-1,1,false,false,false,-1.0
2,2,0.5,0.5,true,false,850,300,849,299,-1,-1,1,true,true,true,-1.0
2,2,0.5,0.5,true,false,350,200,350,200,0,0,0,true,true,true,-1.0
2,2,0.5,0.5,true,false,250,200,798,248,548,48,2,true,true,true,-1.0
2,2,0.5,0.5,true,false,250,850,796,896,546,46,4,true,true,true,-1.0
2,2,0.5,0.5,true,false,200,300,298,898,98,598,2,true,true,true,-1.0
2,2,0.5,0.5,true,false,200,850,199,849,-1,-1,1,false,false,false,-1.0
2,2,0.5,0.5,true,false,350,850,349,849,-1,-1,1,true,true,true,-1.0
2,2,0.5,0.5,true,false,250,850,798,898,548,48,2,true,true,true,-1.0
2,2,0.5,0.5,true,false,300,300,348,798,48,498,2,true,true,true,-1.0
2,2,0.5,0.5,true,false,200,300,248,798,48,498,2,true,true,true,-1.0
2,2,0.5,0.5,true,false,200,300,200,300,0,0,0,true,true,true,-1.0
2,2,0.5,0.5,true,false,200,850,248,898,48,48,2,true,true,true,-1.0
2,2,0.5,0.5,true,false,200,300,198,298,-2,-2,2,true,true,true,-1.0
2,2,0.5,0.5,true,false,200,250,199,249,-1,-1,1,true,true,true,-1.0
2,2,0.5,0.5,true,false,300,850,798,898,498,48,2,true,true,true,-1.0
2,2,0.5,0.5,true,false,300,200,348,798,48,598,2,true,true,true,-1.0
2,2,0.5,0.5,false,true,250,300,249,299,-1,-1,1,true,true,true,118.429
2,2,0.5,0.5,false,true,350,250,350,250,0,0,0,true,true,true,-1.0
2,2,0.5,0.5,false,true,200,900,248,948,48,48,2,true,true,true,-1.0
2,2,0.5,0.5,false,true,200,350,199,349,-1,-1,1,true,true,true,-1.0
2,2,0.5,0.5,false,true,200,300,198,298,-2,-2,2,true,true,true,-1.0
2,2,0.5,0.5,false,true,850,850,850,850,0,0,0,true,true,true,-1.0
2,2,0.5,0.5,false,true,200,200,200,200,0,0,0,true,true,true,-1.0
2,2,0.5,0.5,false,true,250,300,798,948,548,648,2,true,true,true,-1.0
2,2,0.5,0.5,false,true,350,300,898,848,548,548,2,true,true,true,-1.0
2,2,0.5,0.5,false,true,300,250,348,848,48,598,2,true,true,true,-1.0
2,2,0.5,0.5,false,true,200,300,799,949,599,649,1,true,true,true,-1.0
2,2,0.5,0.5,false,true,250,200,248,198,-2,-2,2,true,true,true,-1.0
2,2,0.5,0.5,false,true,850,300,898,798,48,498,2,true,true,true,-1.0
2,2,0.5,0.5,false,true,300,300,348,898,48,598,2,true,true,true,-1.0
2,2,0.5,0.5,false,true,850,250,899,299,49,49,1,true,true,true,-1.0
2,2,0.5,0.5,false,true,300,850,798,898,498,48,2,true,true,true,-1.0
2,2,0.5,0.5,false,true,300,200,299,199,-1,-1,1,true,true,true,-1.0
2,2,0.5,0.5,false,true,300,250,299,249,-1,-1,1,true,true,true,-1.0
2,2,0.5,0.5,false,true,300,200,348,798,48,598,2,true,true,true,-1.0
2,2,0.5,0.5,false,true,200,250,248,798,48,548,2,true,true,true,-1.0
2,2,0.5,0.5,false,false,300,250,299,249,-1,-1,1,true,true,true,83.929
2,2,0.5,0.5,false,false,200,300,199,299,-1,-1,1,true,true,true,-1.0
2,2,0.5,0.5,false,false,200,200,199,199,-1,-1,1,true,true,true,-1.0
2,2,0.5,0.5,false,false,850,300,850,300,0,0,0,true,true,true,-1.0
2,2,0.5,0.5,false,false,350,300,349,299,-1,-1,1,true,true,true,-1.0
2,2,0.5,0.5,false,false,850,250,850,250,0,0,0,true,true,true,-1.0
2,2,0.5,0.5,false,false,250,350,797,397,547,47,3,true,true,true,-1.0
2,2,0.5,0.5,false,false,850,200,899,799,49,599,1,true,true,true,-1.0
2,2,0.5,0.5,false,false,200,200,199,199,-1,-1,1,true,true,true,-1.0
2,2,0.5,0.5,false,false,300,300,299,299,-1,-1,1,true,true,true,-1.0
2,2,0.5,0.5,false,false,200,350,348,898,148,548,2,true,true,true,-1.0
2,2,0.5,0.5,false,false,200,250,797,897,597,647,3,true,true,true,-1.0
2,2,0.5,0.5,false,false,200,250,298,298,98,48,2,true,true,true,-1.0
2,2,0.5,0.5,false,false,300,850,299,849,-1,-1,1,true,true,true,-1.0
2,2,0.5,0.5,false,false,200,850,198,848,-2,-2,2,true,true,true,-1.0
2,2,0.5,0.5,false,false,200,300,798,398,598,98,2,true,true,true,-1.0
2,2,0.5,0.5,false,false,350,300,899,849,549,549,1,true,true,true,-1.0
2,2,0.5,0.5,false,false,850,250,849,249,-1,-1,1,true,true,true,-1.0
2,2,0.5,0.5,false,false,250,300,798,398,548,98,2,true,true,true,-1.0
2,2,0.5,0.5,false,false,300,300,797,897,497,597,3,true,true,true,-1.0
0,0,0.5,0.5,false,false,850,200,848,198,-2,-2,2,true,true,true,0.213
0,0,0.5,0.5,false,false,200,250,197,247,-3,-3,3,false,false,false,-1.0
0,0,0.5,0.5,false,false,200,250,248,798,48,548,2,true,true,true,-1.0
0,0,0.5,0.5,false,false,300,350,296,346,-4,-4,4,false,false,false,-1.0
0,0,0.5,0.5,false,false,250,200,247,197,-3,-3,3,false,false,false,-1.0
0,0,0.5,0.5,false,false,850,850,847,847,-3,-3,3,true,true,true,-1.0
0,0,0.5,0.5,false,false,300,350,298,348,-2,-2,2,true,true,true,-1.0
0,0,0.5,0.5,false,false,200,850,197,847,-3,-3,3,true,true,true,-1.0
0,0,0.5,0.5,false,false,250,300,896,796,646,496,4,true,true,true,-1.0
0,0,0.5,0.5,false,false,200,300,298,898,98,598,2,true,true,true,-1.0
0,0,0.5,0.5,false,false,850,250,898,798,48,548,2,true,true,true,-1.0
0,0,0.5,0.5,false,false,200,250,248,798,48,548,2,true,true,true,-1.0
0,0,0.5,0.5,false,false,300,200,799,799,499,599,1,false,false,true,-1.0
0,0,0.5,0.5,false,false,250,850,799,899,549,49,1,true,true,true,-1.0
0,0,0.5,0.5,false,false,250,200,899,799,649,599,1,true,true,true,-1.0
0,0,0.5,0.5,false,false,350,250,346,246,-4,-4,4,true,true,true,-1.0
0,0,0.5,0.5,false,false,900,850,897,847,-3,-3,3,true,true,true,-1.0
0,0,0.5,0.5,false,false,300,900,297,897,-3,-3,3,true,true,true,-1.0
0,0,0.5,0.5,false,false,300,250,296,246,-4,-4,4,false,false,false,-1.0
0,0,0.5,0.5,false,false,300,300,797,347,497,47,3,true,false,true,-1.0
0,1,0.5,0.5,false,false,850,300,898,798,48,498,2,true,true,true,0.302
0,1,0.5,0.5,false,false,250,300,246,296,-4,-4,4,true,true,true,-1.0
0,1,0.5,0.5,false,false,850,250,846,246,-4,-4,4,true,true,true,-1.0
0,1,0.5,0.5,false,false,300,250,299,249,-1,-1,1,true,true,true,-1.0
0,1,0.5,0.5,false,false,250,200,246,196,-4,-4,4,false,false,false,-1.0
0,1,0.5,0.5,false,false,300,300,297,297,-3,-3,3,true,true,true,-1.0
0,1,0.5,0.5,false,false,250,350,298,898,48,548,2,true,true,true,-1.0
0,1,0.5,0.5,false,false,350,300,898,898,548,598,2,true,true,true,-1.0
0,1,0.5,0.5,false,false,250,200,246,196,-4,-4,4,false,false,false,-1.0
0,1,0.5,0.5,false,false,850,300,848,298,-2,-2,2,true,true,true,-1.0
0,1,0.5,0.5,false,false,250,200,797,347,547,147,3,true,true,true,-1.0
0,1,0.5,0.5,false,false,300,300,849,849,549,549,1,true,true,true,-1.0
0,1,0.5,0.5,false,false,200,850,197,847,-3,-3,3,true,true,true,-1.0
0,1,0.5,0.5,false,false,300,200,296,196,-4,-4,4,false,false,false,-1.0
0,1,0.5,0.5,false,false,200,250,248,898,48,648,2,true,true,true,-1.0
0,1,0.5,0.5,false,false,250,250,797,297,547,47,3,true,true,true,-1.0
0,1,0.5,0.5,false,false,250,350,246,346,-4,-4,4,true,true,true,-1.0
0,1,0.5,0.5,false,false,250,900,247,897,-3,-3,3,true,true,true,-1.0
0,1,0.5,0.5,false,false,300,300,296,296,-4,-4,4,true,true,true,-1.0
0,1,0.5,0.5,false,false,250,300,298,798,48,498,2,true,false,true,-1.0
0,2,0.5,0.5,false,true,300,250,296,246,-4,-4,4,true,true,true,370.674
0,2,0.5,0.5,false,true,300,250,296,246,-4,-4,4,true,true,true,-1.0
0,2,0.5,0.5,false,true,300,250,899,849,599,599,1,true,true,true,-1.0
0,2,0.5,0.5,false,true,350,250,347,247,-3,-3,3,true,true,true,-1.0
0,2,0.5,0.5,false,true,300,350,297,347,-3,-3,3,true,true,true,-1.0
0,2,0.5,0.5,false,true,200,250,199,249,-1,-1,1,true,true,true,-1.0
0,2,0.5,0.5,false,true,250,200,798,398,548,198,2,true,true,true,-1.0
0,2,0.5,0.5,false,true,200,850,199,849,-1,-1,1,true,true,true,-1.0
0,2,0.5,0.5,false,true,300,300,299,299,-1,-1,1,true,true,true,-1.0
0,2,0.5,0.5,false,true,850,300,848,298,-2,-2,2,true,true,true,-1.0
0,2,0.5,0.5,false,true,300,300,298,298,-2,-2,2,true,true,true,-1.0
0,2,0.5,0.5,false,true,200,250,196,246,-4,-4,4,true,true,true,-1.0
0,2,0.5,0.5,false,true,300,850,798,898,498,48,2,true,true,true,-1.0
0,2,0.5,0.5,false,true,250,250,899,899,649,649,1,true,true,true,-1.0
0,2,0.5,0.5,false,true,300,200,799,349,499,149,1,true,true,true,-1.0
0,2,0.5,0.5,false,true,350,300,398,798,48,498,2,true,true,true,-1.0
0,2,0.5,0.5,false,true,300,200,799,899,499,699,1,true,true,true,-1.0
0,2,0.5,0.5,false,true,300,850,296,846,-4,-4,4,true,true,true,-1.0
0,2,0.5,0.5,false,true,300,300,899,849,599,549,1,true,true,true,-1.0
0,2,0.5,0.5,false,true,300,250,797,347,497,97,3,true,false,true,-1.0
0,2,0.5,0.5,false,false,200,250,248,298,48,48,2,true,true,true,64.527
0,2,0.5,0.5,false,false,300,200,348,798,48,598,2,true,true,true,-1.0
0,2,0.5,0.5,false,false,200,300,248,798,48,498,2,true,true,true,-1.0
0,2,0.5,0.5,false,false,200,300,799,399,599,99,1,true,true,true,-1.0
0,2,0.5,0.5,false,false,250,300,849,849,599,549,1,true,true,true,-1.0
0,2,0.5,0.5,false,false,200,850,199,849,-1,-1,1,true,true,true,-1.0
0,2,0.5,0.5,false,false,850,350,849,349,-1,-1,1,true,true,true,-1.0
0,2,0.5,0.5,false,false,250,250,348,798,98,548,2,true,false,true,-1.0
0,2,0.5,0.5,false,false,850,250,846,246,-4,-4,4,true,true,true,-1.0
0,2,0.5,0.5,false,false,250,200,296,346,46,146,4,true,false,true,-1.0
0,2,0.5,0.5,false,false,850,200,848,198,-2,-2,2,true,true,true,-1.0
0,2,0.5,0.5,false,false,200,200,799,799,599,599,1,true,true,true,-1.0
0,2,0.5,0.5,false,false,300,300,296,296,-4,-4,4,true,true,true,-1.0
0,2,0.5,0.5,false,false,300,300,849,849,549,549,1,true,true,true,-1.0
0,2,0.5,0.5,false,false,200,200,199,199,-1,-1,1,true,true,true,-1.0
0,2,0.5,0.5,false,false,300,250,348,848,48,598,2,true,true,true,-1.0
0,2,0.5,0.5,false,false,300,300,849,849,549,549,1,true,true,true,-1.0
0,2,0.5,0.5,false,false,250,300,246,296,-4,-4,4,true,true,true,-1.0
0,2,0.5,0.5,false,false,300,250,799,299,499,49,1,true,true,true,-1.0
0,2,0.5,0.5,false,false,300,350,897,897,597,547,3,true,true,true,-1.0
1,0,0.5,0.5,false,false,250,200,898,798,648,598,2,true,true,true,0.334
1,0,0.5,0.5,false,false,300,250,300,250,0,0,0,true,true,true,-1.0
1,0,0.5,0.5,false,false,300,250,797,297,497,47,3,true,true,true,-1.0
1,0,0.5,0.5,false,false,300,850,295,845,-5,-5,5,true,true,true,-1.0
1,0,0.5,0.5,false,false,850,300,850,300,0,0,0,true,true,true,-1.0
1,0,0.5,0.5,false,false,300,250,300,250,0,0,0,true,true,true,-1.0
1,0,0.5,0.5,false,false,300,350,295,345,-5,-5,5,false,false,false,-1.0
1,0,0.5,0.5,false,false,250,200,250,200,0,0,0,true,true,true,-1.0
1,0,0.5,0.5,false,false,250,350,299,899,49,549,1,true,true,true,-1.0
1,0,0.5,0.5,false,false,300,200,799,249,499,49,1,true,true,true,-1.0
1,0,0.5,0.5,false,false,200,300,799,349,599,49,1,true,true,true,-1.0
1,0,0.5,0.5,false,false,250,850,250,850,0,0,0,true,true,true,-1.0
1,0,0.5,0.5,false,false,300,300,300,300,0,0,0,true,true,true,-1.0
1,0,0.5,0.5,false,false,850,350,846,346,-4,-4,4,true,true,true,-1.0
1,0,0.5,0.5,false,false,300,250,297,247,-3,-3,3,true,true,true,-1.0
1,0,0.5,0.5,false,false,850,300,847,297,-3,-3,3,true,true,true,-1.0
1,0,0.5,0.5,false,false,250,300,849,849,599,549,1,true,true,true,-1.0
1,0,0.5,0.5,false,false,850,250,848,248,-2,-2,2,true,true,true,-1.0
1,0,0.5,0.5,false,false,250,350,247,347,-3,-3,3,true,true,true,-1.0
1,0,0.5,0.5,false,false,250,250,899,799,649,549,1,true,true,true,-1.0
1,1,0.5,0.5,false,false,250,300,299,349,49,49,1,true,true,true,1.133
1,1,0.5,0.5,false,false,250,250,200,200,-50,-50,50,false,false,false,-1.0
1,1,0.5,0.5,false,false,300,250,296,246,-4,-4,4,true,true,true,-1.0
1,1,0.5,0.5,false,false,300,250,348,798,48,548,2,true,true,true,-1.0
1,1,0.5,0.5,false,false,200,300,798,898,598,598,2,true,true,true,-1.0
1,1,0.5,0.5,false,false,900,300,850,250,-50,-50,50,true,true,true,-1.0
1,1,0.5,0.5,false,false,850,300,898,798,48,498,2,true,true,true,-1.0
1,1,0.5,0.5,false,false,300,250,250,200,-50,-50,50,true,true,true,-1.0
1,1,0.5,0.5,false,false,350,250,300,200,-50,-50,50,true,true,true,-1.0
1,1,0.5,0.5,false,false,250,850,247,847,-3,-3,3,true,true,true,-1.0
1,1,0.5,0.5,false,false,250,850,247,847,-3,-3,3,true,true,true,-1.0
1,1,0.5,0.5,false,false,300,300,799,949,499,649,1,true,true,true,-1.0
1,1,0.5,0.5,false,false,200,850,199,849,-1,-1,1,true,true,true,-1.0
1,1,0.5,0.5,false,false,250,250,200,200,-50,-50,50,false,false,false,-1.0
1,1,0.5,0.5,false,false,250,300,200,250,-50,-50,50,false,false,false,-1.0
1,1,0.5,0.5,false,false,350,350,350,350,0,0,0,true,true,true,-1.0
1,1,0.5,0.5,false,false,250,200,799,299,549,99,1,true,true,true,-1.0
1,1,0.5,0.5,false,false,250,200,797,247,547,47,3,true,true,true,-1.0
1,1,0.5,0.5,false,false,300,300,250,250,-50,-50,50,true,true,true,-1.0
1,1,0.5,0.5,false,false,300,350,300,350,0,0,0,true,true,true,-1.0
1,2,0.5,0.5,false,true,250,250,248,248,-2,-2,2,true,true,true,648.423
1,2,0.5,0.5,false,true,300,200,799,349,499,149,1,true,true,true,-1.0
1,2,0.5,0.5,false,true,200,350,248,898,48,548,2,true,false,true,-1.0
1,2,0.5,0.5,false,true,900,300,850,250,-50,-50,50,false,false,false,-1.0
1,2,0.5,0.5,false,true,200,350,150,300,-50,-50,50,false,false,false,-1.0
1,2,0.5,0.5,false,true,200,200,200,200,0,0,0,true,true,true,-1.0
1,2,0.5,0.5,false,true,200,250,150,200,-50,-50,50,false,false,false,-1.0
1,2,0.5,0.5,false,true,850,200,850,200,0,0,0,true,true,true,-1.0
1,2,0.5,0.5,false,true,200,200,200,200,0,0,0,true,true,true,-1.0
1,2,0.5,0.5,false,true,300,850,298,848,-2,-2,2,true,true,true,-1.0
1,2,0.5,0.5,false,true,300,200,300,200,0,0,0,false,false,false,-1.0
1,2,0.5,0.5,false,true,200,850,199,849,-1,-1,1,true,true,true,-1.0
1,2,0.5,0.5,false,true,200,250,150,200,-50,-50,50,false,false,false,-1.0
1,2,0.5,0.5,false,true,200,250,197,297,-3,47,3,true,true,true,-1.0
1,2,0.5,0.5,false,true,850,850,848,848,-2,-2,2,true,true,true,-1.0
1,2,0.5,0.5,false,true,350,250,396,796,46,546,4,true,true,true,-1.0
1,2,0.5,0.5,false,true,200,300,898,848,698,548,2,true,true,true,-1.0
1,2,0.5,0.5,false,true,250,250,799,899,549,649,1,true,true,true,-1.0
1,2,0.5,0.5,false,true,200,350,246,396,46,46,4,true,true,true,-1.0
1,2,0.5,0.5,false,true,350,300,348,298,-2,-2,2,true,true,true,-1.0
1,2,0.5,0.5,false,false,300,250,799,949,499,699,1,true,true,true,67.115
1,2,0.5,0.5,false,false,900,350,900,350,0,0,0,true,true,true,-1.0
1,2,0.5,0.5,false,false,200,850,199,849,-1,-1,1,true,true,true,-1.0
1,2,0.5,0.5,false,false,300,250,799,349,499,99,1,true,true,true,-1.0
1,2,0.5,0.5,false,false,250,300,346,796,96,496,4,true,true,true,-1.0
1,2,0.5,0.5,false,false,250,250,349,799,99,549,1,true,true,true,-1.0
1,2,0.5,0.5,false,false,350,850,349,849,-1,-1,1,true,true,true,-1.0
1,2,0.5,0.5,false,false,250,250,299,299,49,49,1,true,true,true,-1.0
1,2,0.5,0.5,false,false,350,850,348,848,-2,-2,2,true,true,true,-1.0
1,2,0.5,0.5,false,false,250,350,799,949,549,599,1,true,true,true,-1.0
1,2,0.5,0.5,false,false,250,300,250,300,0,0,0,true,true,true,-1.0
1,2,0.5,0.5,false,false,300,250,298,248,-2,-2,2,true,true,true,-1.0
1,2,0.5,0.5,false,false,850,900,848,898,-2,-2,2,true,true,true,-1.0
1,2,0.5,0.5,false,false,850,200,848,198,-2,-2,2,true,true,true,-1.0
1,2,0.5,0.5,false,false,300,300,949,799,649,499,1,true,true,true,-1.0
1,2,0.5,0.5,false,false,300,250,298,248,-2,-2,2,true,true,true,-1.0
1,2,0.5,0.5,false,false,200,200,198,198,-2,-2,2,true,true,true,-1.0
1,2,0.5,0.5,false,false,300,300,799,949,499,649,1,true,true,true,-1.0
1,2,0.5,0.5,false,false,850,250,800,200,-50,-50,50,false,false,false,-1.0
1,2,0.5,0.5,false,false,250,850,799,899,549,49,1,true,true,true,-1.0
2,0,0.5,0.5,true,false,850,250,845,245,-5,-5,5,true,true,true,549.294
2,0,0.5,0.5,true,false,200,200,197,197,-3,-3,3,false,false,false,-1.0
2,0,0.5,0.5,true,false,250,200,250,200,0,0,0,true,true,true,-1.0
2,0,0.5,0.5,true,false,300,250,847,297,547,47,3,true,true,true,-1.0
2,0,0.5,0.5,true,false,850,300,899,799,49,499,1,true,true,true,-1.0
2,0,0.5,0.5,true,false,250,850,247,847,-3,-3,3,true,true,true,-1.0
2,0,0.5,0.5,true,false,200,300,197,297,-3,-3,3,true,true,true,-1.0
2,0,0.5,0.5,true,false,300,250,297,247,-3,-3,3,true,true,true,-1.0
2,0,0.5,0.5,true,false,900,250,900,250,0,0,0,true,true,true,-1.0
2,0,0.5,0.5,true,false,850,200,845,195,-5,-5,5,true,true,true,-1.0
2,0,0.5,0.5,true,false,850,300,899,799,49,499,1,true,true,true,-1.0
2,0,0.5,0.5,true,false,300,300,300,300,0,0,0,true,true,true,-1.0
2,0,0.5,0.5,true,false,300,300,349,799,49,499,1,false,false,true,-1.0
2,0,0.5,0.5,true,false,200,200,195,195,-5,-5,5,true,true,true,-1.0
2,0,0.5,0.5,true,false,200,250,195,245,-5,-5,5,true,true,true,-1.0
2,0,0.5,0.5,true,false,300,200,897,297,597,97,3,true,true,true,-1.0
2,0,0.5,0.5,true,false,250,250,246,246,-4,-4,4,true,true,true,-1.0
2,0,0.5,0.5,true,false,200,200,200,200,0,0,0,true,true,true,-1.0
2,0,0.5,0.5,true,false,300,250,300,250,0,0,0,true,true,true,-1.0
2,0,0.5,0.5,true,false,200,250,197,247,-3,-3,3,true,true,true,-1.0
2,0,0.5,0.5,false,false,300,200,300,200,0,0,0,true,true,true,90.959
2,0,0.5,0.5,false,false,300,300,799,899,499,599,1,true,true,true,-1.0
2,0,0.5,0.5,false,false,300,350,799,949,499,599,1,true,true,true,-1.0
2,0,0.5,0.5,false,false,850,850,847,847,-3,-3,3,true,true,true,-1.0
2,0,0.5,0.5,false,false,250,850,247,847,-3,-3,3,true,true,true,-1.0
2,0,0.5,0.5,false,false,250,850,247,847,-3,-3,3,true,true,true,-1.0
2,0,0.5,0.5,false,false,300,350,295,345,-5,-5,5,true,true,true,-1.0
2,0,0.5,0.5,false,false,200,300,200,300,0,0,0,true,true,true,-1.0
2,0,0.5,0.5,false,false,300,850,297,847,-3,-3,3,true,true,true,-1.0
2,0,0.5,0.5,false,false,200,300,197,297,-3,-3,3,true,true,true,-1.0
2,0,0.5,0.5,false,false,250,200,897,247,647,47,3,true,true,true,-1.0
2,0,0.5,0.5,false,false,300,300,896,796,596,496,4,true,true,true,-1.0
2,0,0.5,0.5,false,false,250,200,245,195,-5,-5,5,true,true,true,-1.0
2,0,0.5,0.5,false,false,250,300,797,347,547,47,3,true,true,true,-1.0
2,0,0.5,0.5,false,false,200,200,200,200,0,0,0,true,true,true,-1.0
2,0,0.5,0.5,false,false,250,300,797,347,547,47,3,true,true,true,-1.0
2,0,0.5,0.5,false,false,300,300,295,295,-5,-5,5,true,true,true,-1.0
2,0,0.5,0.5,false,false,250,850,247,847,-3,-3,3,true,true,true,-1.0
2,0,0.5,0.5,false,false,300,200,898,798,598,598,2,true,true,true,-1.0
2,0,0.5,0.5,false,false,250,250,899,799,649,549,1,true,true,true,-1.0
2,1,0.5,0.5,true,false,200,250,197,247,-3,-3,3,true,true,true,1079.64
2,1,0.5,0.5,true,false,300,300,849,849,549,549,1,true,true,true,-1.0
2,1,0.5,0.5,true,false,250,200,247,197,-3,-3,3,true,true,true,-1.0
2,1,0.5,0.5,true,false,350,300,350,300,0,0,0,true,true,true,-1.0
2,1,0.5,0.5,true,false,350,250,350,250,0,0,0,true,true,true,-1.0
2,1,0.5,0.5,true,false,850,300,849,299,-1,-1,1,true,true,true,-1.0
2,1,0.5,0.5,true,false,350,250,347,247,-3,-3,3,true,true,true,-1.0
2,1,0.5,0.5,true,false,200,300,798,348,598,48,2,true,true,true,-1.0
2,1,0.5,0.5,true,false,850,250,847,247,-3,-3,3,true,true,true,-1.0
2,1,0.5,0.5,true,false,250,300,797,897,547,597,3,true,true,true,-1.0
2,1,0.5,0.5,true,false,300,350,798,948,498,598,2,true,true,true,-1.0
2,1,0.5,0.5,true,false,300,250,799,299,499,49,1,true,true,true,-1.0
2,1,0.5,0.5,true,false,200,850,197,847,-3,-3,3,true,true,true,-1.0
2,1,0.5,0.5,true,false,200,200,197,197,-3,-3,3,true,true,true,-1.0
2,1,0.5,0.5,true,false,300,300,300,300,0,0,0,true,true,true,-1.0
2,1,0.5,0.5,true,false,350,300,347,297,-3,-3,3,true,true,true,-1.0
2,1,0.5,0.5,true,false,250,850,799,899,549,49,1,true,true,true,-1.0
2,1,0.5,0.5,true,false,300,850,297,847,-3,-3,3,true,true,true,-1.0
2,1,0.5,0.5,true,false,300,300,348,798,48,498,2,true,true,true,-1.0
2,1,0.5,0.5,true,false,850,300,847,297,-3,-3,3,true,true,true,-1.0
2,1,0.5,0.5,false,false,200,200,193,193,-7,-7,7,true,true,true,169.255
2,1,0.5,0.5,false,false,250,250,797,897,547,647,3,true,true,true,-1.0
2,1,0.5,0.5,false,false,250,300,898,798,648,498,2,true,true,true,-1.0
2,1,0.5,0.5,false,false,250,300,247,297,-3,-3,3,true,true,true,-1.0
2,1,0.5,0.5,false,false,300,850,283,833,-17,-17,17,true,true,true,-1.0
2,1,0.5,0.5,false,false,250,850,247,847,-3,-3,3,true,true,true,-1.0
2,1,0.5,0.5,false,false,250,300,266,766,16,466,34,true,true,true,-1.0
2,1,0.5,0.5,false,false,300,250,297,247,-3,-3,3,true,true,true,-1.0
2,1,0.5,0.5,false,false,300,300,799,899,499,599,1,true,true,true,-1.0
2,1,0.5,0.5,false,false,200,300,898,798,698,498,2,true,true,true,-1.0
2,1,0.5,0.5,false,false,300,350,297,347,-3,-3,3,true,true,true,-1.0
2,1,0.5,0.5,false,false,300,300,797,347,497,47,3,true,true,true,-1.0
2,1,0.5,0.5,false,false,250,300,299,799,49,499,1,true,true,true,-1.0
2,1,0.5,0.5,false,false,850,850,847,847,-3,-3,3,true,true,true,-1.0
2,1,0.5,0.5,false,false,250,250,250,250,0,0,0,true,true,true,-1.0
2,1,0.5,0.5,false,false,300,300,297,297,-3,-3,3,true,true,true,-1.0
2,1,0.5,0.5,false,false,350,250,350,250,0,0,0,true,true,true,-1.0
2,1,0.5,0.5,false,false,300,200,797,247,497,47,3,true,true,true,-1.0
2,1,0.5,0.5,false,false,850,250,847,247,-3,-3,3,true,true,true,-1.0
2,1,0.5,0.5,false,false,200,250,197,247,-3,-3,3,true,true,true,-1.0
2,2,0.5,0.5,true,true,300,300,300,300,0,0,0,true,true,true,457.07
2,2,0.5,0.5,true,true,850,200,899,799,49,599,1,true,true,true,-1.0
2,2,0.5,0.5,true,true,300,300,299,299,-1,-1,1,true,true,true,-1.0
2,2,0.5,0.5,true,true,350,250,350,250,0,0,0,true,true,true,-1.0
2,2,0.5,0.5,true,true,200,200,198,198,-2,-2,2,true,true,true,-1.0
2,2,0.5,0.5,true,true,200,300,200,300,0,0,0,true,true,true,-1.0
2,2,0.5,0.5,true,true,250,300,898,798,648,498,2,true,true,true,-1.0
2,2,0.5,0.5,true,true,200,250,248,898,48,648,2,true,false,true,-1.0
2,2,0.5,0.5,true,true,350,200,399,299,49,99,1,true,true,true,-1.0
2,2,0.5,0.5,true,true,300,300,349,799,49,499,1,true,true,true,-1.0
2,2,0.5,0.5,true,true,300,200,348,298,48,98,2,true,true,true,-1.0
2,2,0.5,0.5,true,true,200,200,200,200,0,0,0,true,true,true,-1.0
2,2,0.5,0.5,true,true,850,350,850,350,0,0,0,true,true,true,-1.0
2,2,0.5,0.5,true,true,300,250,398,798,98,548,2,true,true,true,-1.0
2,2,0.5,0.5,true,true,200,850,248,898,48,48,2,true,true,true,-1.0
2,2,0.5,0.5,true,true,300,250,798,898,498,648,2,true,true,true,-1.0
2,2,0.5,0.5,true,true,850,200,849,199,-1,-1,1,true,true,true,-1.0
2,2,0.5,0.5,true,true,850,250,898,798,48,548,2,true,true,true,-1.0
2,2,0.5,0.5,true,true,250,250,798,298,548,48,2,true,true,true,-1.0
2,2,0.5,0.5,true,true,250,250,248,248,-2,-2,2,true,true,true,-1.0
2,2,0.5,0.5,true,false,200,300,200,300,0,0,0,true,true,true,437.767
2,2,0.5,0.5,true,false,300,200,250,150,-50,-50,50,false,false,false,-1.0
2,2,0.5,0.5,true,false,300,200,297,197,-3,-3,3,true,true,true,-1.0
2,2,0.5,0.5,true,false,300,250,798,898,498,648,2,true,true,true,-1.0
2,2,0.5,0.5,true,false,300,900,300,900,0,0,0,true,true,true,-1.0
2,2,0.5,0.5,true,false,900,350,900,350,0,0,0,true,true,true,-1.0
2,2,0.5,0.5,true,false,900,900,900,900,0,0,0,true,true,true,-1.0
2,2,0.5,0.5,true,false,200,250,789,289,589,39,11,true,true,true,-1.0
2,2,0.5,0.5,true,false,300,850,799,899,499,49,1,true,true,true,-1.0
2,2,0.5,0.5,true,false,250,250,248,248,-2,-2,2,true,true,true,-1.0
2,2,0.5,0.5,true,false,200,200,249,249,49,49,1,true,true,true,-1.0
2,2,0.5,0.5,true,false,200,250,198,248,-2,-2,2,true,true,true,-1.0
2,2,0.5,0.5,true,false,850,300,899,799,49,499,1,true,true,true,-1.0
2,2,0.5,0.5,true,false,900,250,900,250,0,0,0,true,true,true,-1.0
2,2,0.5,0.5,true,false,200,300,248,348,48,48,2,true,true,true,-1.0
2,2,0.5,0.5,true,false,250,850,249,849,-1,-1,1,false,false,false,-1.0
2,2,0.5,0.5,true,false,250,250,344,794,94,544,6,true,true,true,-1.0
2,2,0.5,0.5,true,false,200,200,249,249,49,49,1,true,true,true,-1.0
2,2,0.5,0.5,true,false,300,250,898,798,598,548,2,true,true,true,-1.0
2,2,0.5,0.5,true,false,250,200,249,199,-1,-1,1,true,true,true,-1.0
2,2,0.5,0.5,false,true,300,350,299,349,-1,-1,1,true,true,true,160.726
2,2,0.5,0.5,false,true,300,350,848,898,548,548,2,true,true,true,-1.0
2,2,0.5,0.5,false,true,850,250,898,798,48,548,2,true,true,true,-1.0
2,2,0.5,0.5,false,true,250,300,248,298,-2,-2,2,true,true,true,-1.0
2,2,0.5,0.5,false,true,350,250,397,797,47,547,3,true,true,true,-1.0
2,2,0.5,0.5,false,true,350,300,347,297,-3,-3,3,true,true,true,-1.0
2,2,0.5,0.5,false,true,850,850,850,850,0,0,0,true,true,true,-1.0
2,2,0.5,0.5,false,true,300,300,898,798,598,498,2,true,true,true,-1.0
2,2,0.5,0.5,false,true,250,300,799,899,549,599,1,true,true,true,-1.0
2,2,0.5,0.5,false,true,200,250,248,298,48,48,2,true,true,true,-1.0
2,2,0.5,0.5,false,true,200,200,199,199,-1,-1,1,true,true,true,-1.0
2,2,0.5,0.5,false,true,300,200,799,249,499,49,1,true,true,true,-1.0
2,2,0.5,0.5,false,true,200,200,200,200,0,0,0,true,true,true,-1.0
2,2,0.5,0.5,false,true,350,300,349,299,-1,-1,1,true,true,true,-1.0
2,2,0.5,0.5,false,true,300,250,797,347,497,97,3,true,true,true,-1.0
2,2,0.5,0.5,false,true,850,300,849,299,-1,-1,1,true,true,true,-1.0
2,2,0.5,0.5,false,true,300,250,797,297,497,47,3,true,true,true,-1.0
2,2,0.5,0.5,false,true,300,200,300,200,0,0,0,true,true,true,-1.0
2,2,0.5,0.5,false,true,200,200,200,200,0,0,0,true,true,true,-1.0
2,2,0.5,0.5,false,true,850,250,898,798,48,548,2,true,true,true,-1.0
2,2,0.5,0.5,false,false,850,200,849,199,-1,-1,1,true,true,true,95.479
2,2,0.5,0.5,false,false,350,350,349,349,-1,-1,1,true,true,true,-1.0
2,2,0.5,0.5,false,false,300,250,299,249,-1,-1,1,true,true,true,-1.0
2,2,0.5,0.5,false,false,250,350,798,398,548,48,2,true,true,true,-1.0
2,2,0.5,0.5,false,false,300,250,299,249,-1,-1,1,true,true,true,-1.0
2,2,0.5,0.5,false,false,850,300,850,300,0,0,0,true,true,true,-1.0
2,2,0.5,0.5,false,false,200,350,298,898,98,548,2,true,true,true,-1.0
2,2,0.5,0.5,false,false,250,300,244,294,-6,-6,6,true,true,true,-1.0
2,2,0.5,0.5,false,false,250,300,248,298,-2,-2,2,true,true,true,-1.0
2,2,0.5,0.5,false,false,250,300,250,300,0,0,0,true,true,true,-1.0
2,2,0.5,0.5,false,false,350,200,899,849,549,649,1,true,true,true,-1.0
2,2,0.5,0.5,false,false,300,250,797,297,497,47,3,true,true,true,-1.0
2,2,0.5,0.5,false,false,850,300,850,300,0,0,0,true,true,true,-1.0
2,2,0.5,0.5,false,false,850,300,849,299,-1,-1,1,true,true,true,-1.0
2,2,0.5,0.5,false,false,200,200,248,298,48,98,2,true,true,true,-1.0
2,2,0.5,0.5,false,false,200,850,198,848,-2,-2,2,true,true,true,-1.0
2,2,0.5,0.5,false,false,300,350,299,349,-1,-1,1,true,true,true,-1.0
2,2,0.5,0.5,false,false,300,200,797,297,497,97,3,true,true,true,-1.0
2,2,0.5,0.5,false,false,200,850,199,849,-1,-1,1,true,true,true,-1.0
2,2,0.5,0.5,false,false,850,350,850,350,0,0,0,true,true,true,-1.0
0,0,0.5,0.5,false,false,300,850,297,847,-3,-3,3,true,true,true,0.177
0,0,0.5,0.5,false,false,200,200,197,197,-3,-3,3,true,true,true,-1.0
0,0,0.5,0.5,false,false,250,200,297,247,47,47,3,true,false,true,-1.0
0,0,0.5,0.5,false,false,250,250,298,898,48,648,2,true,true,true,-1.0
0,0,0.5,0.5,false,false,350,300,348,298,-2,-2,2,true,true,true,-1.0
0,0,0.5,0.5,false,false,250,300,247,297,-3,-3,3,true,true,true,-1.0
0,0,0.5,0.5,false,false,200,200,198,198,-2,-2,2,true,true,true,-1.0
0,0,0.5,0.5,false,false,300,200,799,249,499,49,1,true,true,true,-1.0
0,0,0.5,0.5,false,false,250,850,247,847,-3,-3,3,false,false,false,-1.0
0,0,0.5,0.5,false,false,250,250,799,299,549,49,1,true,true,true,-1.0
0,0,0.5,0.5,false,false,200,200,198,198,-2,-2,2,true,true,true,-1.0
0,0,0.5,0.5,false,false,300,250,797,347,497,97,3,true,false,true,-1.0
0,0,0.5,0.5,false,false,300,850,297,847,-3,-3,3,true,true,true,-1.0
0,0,0.5,0.5,false,false,900,850,898,848,-2,-2,2,true,true,true,-1.0
0,0,0.5,0.5,false,false,850,200,898,798,48,598,2,true,true,true,-1.0
0,0,0.5,0.5,false,false,350,250,948,798,598,548,2,true,true,true,-1.0
0,0,0.5,0.5,false,false,850,350,848,348,-2,-2,2,true,true,true,-1.0
0,0,0.5,0.5,false,false,200,300,247,397,47,97,3,false,false,true,-1.0
0,0,0.5,0.5,false,false,300,350,799,949,499,599,1,true,true,true,-1.0
0,0,0.5,0.5,false,false,300,300,297,297,-3,-3,3,true,true,true,-1.0
0,1,0.5,0.5,false,false,300,200,799,299,499,99,1,true,true,true,0.289
0,1,0.5,0.5,false,false,200,300,197,297,-3,-3,3,true,true,true,-1.0
0,1,0.5,0.5,false,false,250,850,249,849,-1,-1,1,true,true,true,-1.0
0,1,0.5,0.5,false,false,250,350,298,398,48,48,2,true,true,true,-1.0
0,1,0.5,0.5,false,false,900,300,896,296,-4,-4,4,true,true,true,-1.0
0,1,0.5,0.5,false,false,250,250,298,298,48,48,2,true,true,true,-1.0
0,1,0.5,0.5,false,false,250,250,249,249,-1,-1,1,true,true,true,-1.0
0,1,0.5,0.5,false,false,250,200,246,196,-4,-4,4,true,true,true,-1.0
0,1,0.5,0.5,false,false,300,200,797,247,497,47,3,true,true,true,-1.0
0,1,0.5,0.5,false,false,350,900,346,896,-4,-4,4,true,true,true,-1.0
0,1,0.5,0.5,false,false,200,300,296,346,96,46,4,true,true,true,-1.0
0,1,0.5,0.5,false,false,200,300,196,296,-4,-4,4,true,true,true,-1.0
0,1,0.5,0.5,false,false,300,850,799,899,499,49,1,true,true,true,-1.0
0,1,0.5,0.5,false,false,200,300,197,297,-3,-3,3,true,true,true,-1.0
0,1,0.5,0.5,false,false,300,250,348,798,48,548,2,true,true,true,-1.0
0,1,0.5,0.5,false,false,900,300,898,298,-2,-2,2,true,true,true,-1.0
0,1,0.5,0.5,false,false,250,850,246,846,-4,-4,4,true,true,true,-1.0
0,1,0.5,0.5,false,false,300,350,296,346,-4,-4,4,true,true,true,-1.0
0,1,0.5,0.5,false,false,300,200,296,196,-4,-4,4,true,true,true,-1.0
0,1,0.5,0.5,false,false,250,250,246,246,-4,-4,4,true,true,true,-1.0
0,2,0.5,0.5,false,true,300,300,296,296,-4,-4,4,true,true,true,280.328
0,2,0.5,0.5,false,true,200,850,199,849,-1,-1,1,true,true,true,-1.0
0,2,0.5,0.5,false,true,250,250,249,249,-1,-1,1,true,true,true,-1.0
0,2,0.5,0.5,false,true,300,900,798,948,498,48,2,true,true,true,-1.0
0,2,0.5,0.5,false,true,300,200,296,196,-4,-4,4,false,false,false,-1.0
0,2,0.5,0.5,false,true,850,300,846,296,-4,-4,4,true,true,true,-1.0
0,2,0.5,0.5,false,true,300,300,398,798,98,498,2,true,true,true,-1.0
0,2,0.5,0.5,false,true,300,300,348,798,48,498,2,true,true,true,-1.0
0,2,0.5,0.5,false,true,200,200,196,196,-4,-4,4,true,true,true,-1.0
0,2,0.5,0.5,false,true,300,250,348,798,48,548,2,true,true,true,-1.0
0,2,0.5,0.5,false,true,350,300,898,848,548,548,2,true,true,true,-1.0
0,2,0.5,0.5,false,true,300,850,296,846,-4,-4,4,true,true,true,-1.0
0,2,0.5,0.5,false,true,200,250,199,249,-1,-1,1,true,true,true,-1.0
0,2,0.5,0.5,false,true,250,200,246,196,-4,-4,4,false,false,false,-1.0
0,2,0.5,0.5,false,true,250,200,296,346,46,146,4,true,false,true,-1.0
0,2,0.5,0.5,false,true,200,850,199,849,-1,-1,1,true,true,true,-1.0
0,2,0.5,0.5,false,true,300,200,296,196,-4,-4,4,true,true,true,-1.0
0,2,0.5,0.5,false,true,350,200,346,196,-4,-4,4,true,true,true,-1.0
0,2,0.5,0.5,false,true,200,300,196,296,-4,-4,4,true,true,true,-1.0
0,2,0.5,0.5,false,true,300,250,296,246,-4,-4,4,true,true,true,-1.0
0,2,0.5,0.5,false,false,850,250,849,249,-1,-1,1,true,true,true,68.521
0,2,0.5,0.5,false,false,850,200,848,198,-2,-2,2,true,true,true,-1.0
0,2,0.5,0.5,false,false,250,900,247,897,-3,-3,3,true,true,true,-1.0
0,2,0.5,0.5,false,false,200,300,196,296,-4,-4,4,true,true,true,-1.0
0,2,0.5,0.5,false,false,250,300,346,796,96,496,4,true,true,true,-1.0
0,2,0.5,0.5,false,false,300,300,898,798,598,498,2,true,true,true,-1.0
0,2,0.5,0.5,false,false,250,350,249,349,-1,-1,1,true,true,true,-1.0
0,2,0.5,0.5,false,false,850,300,846,296,-4,-4,4,true,true,true,-1.0
0,2,0.5,0.5,false,false,850,900,849,899,-1,-1,1,true,true,true,-1.0
0,2,0.5,0.5,false,false,300,200,797,347,497,147,3,true,true,true,-1.0
0,2,0.5,0.5,false,false,200,300,248,798,48,498,2,true,true,true,-1.0
0,2,0.5,0.5,false,false,850,200,846,196,-4,-4,4,true,true,true,-1.0
0,2,0.5,0.5,false,false,200,850,196,846,-4,-4,4,true,true,true,-1.0
0,2,0.5,0.5,false,false,250,350,797,397,547,47,3,true,true,true,-1.0
0,2,0.5,0.5,false,false,250,250,246,246,-4,-4,4,false,false,false,-1.0
0,2,0.5,0.5,false,false,300,200,296,196,-4,-4,4,true,true,true,-1.0
0,2,0.5,0.5,false,false,300,300,799,899,499,599,1,true,true,true,-1.0
0,2,0.5,0.5,false,false,200,300,197,297,-3,-3,3,true,true,true,-1.0
0,2,0.5,0.5,false,false,250,200,348,798,98,598,2,true,true,true,-1.0
0,2,0.5,0.5,false,false,250,850,247,847,-3,-3,3,true,true,true,-1.0
1,0,0.5,0.5,false,false,250,300,348,798,98,498,2,true,true,true,0.304
1,0,0.5,0.5,false,false,350,200,399,799,49,599,1,true,true,true,-1.0
1,0,0.5,0.5,false,false,250,200,397,247,147,47,3,true,true,true,-1.0
1,0,0.5,0.5,false,false,250,200,848,898,598,698,2,true,true,true,-1.0
1,0,0.5,0.5,false,false,300,300,300,300,0,0,0,true,true,true,-1.0
1,0,0.5,0.5,false,false,300,250,797,297,497,47,3,true,false,true,-1.0
1,0,0.5,0.5,false,false,300,200,797,247,497,47,3,true,true,true,-1.0
1,0,0.5,0.5,false,false,350,250,899,849,549,599,1,true,true,true,-1.0
1,0,0.5,0.5,false,false,300,850,297,847,-3,-3,3,true,true,true,-1.0
1,0,0.5,0.5,false,false,300,250,297,247,-3,-3,3,false,false,false,-1.0
1,0,0.5,0.5,false,false,850,300,899,799,49,499,1,true,true,true,-1.0
1,0,0.5,0.5,false,false,250,850,797,897,547,47,3,true,true,true,-1.0
1,0,0.5,0.5,false,false,250,200,247,197,-3,-3,3,true,true,true,-1.0
1,0,0.5,0.5,false,false,300,300,295,295,-5,-5,5,true,true,true,-1.0
1,0,0.5,0.5,false,false,300,250,799,349,499,99,1,true,true,true,-1.0
1,0,0.5,0.5,false,false,350,200,397,247,47,47,3,true,true,true,-1.0
1,0,0.5,0.5,false,false,250,250,247,247,-3,-3,3,true,true,true,-1.0
1,0,0.5,0.5,false,false,300,250,847,847,547,597,3,true,true,true,-1.0
1,0,0.5,0.5,false,false,300,200,799,299,499,99,1,true,true,true,-1.0
1,0,0.5,0.5,false,false,250,250,799,949,549,699,1,true,true,true,-1.0
1,1,0.5,0.5,false,false,200,300,197,297,-3,-3,3,true,true,true,1.273
1,1,0.5,0.5,false,false,300,300,250,250,-50,-50,50,true,true,true,-1.0
1,1,0.5,0.5,false,false,200,200,200,200,0,0,0,true,true,true,-1.0
1,1,0.5,0.5,false,false,200,300,299,799,99,499,1,true,true,true,-1.0
1,1,0.5,0.5,false,false,300,200,898,798,598,598,2,true,true,true,-1.0
1,1,0.5,0.5,false,false,300,250,250,200,-50,-50,50,true,true,true,-1.0
1,1,0.5,0.5,false,false,850,200,800,150,-50,-50,50,true,true,true,-1.0
1,1,0.5,0.5,false,false,300,300,300,300,0,0,0,true,true,true,-1.0
1,1,0.5,0.5,false,false,250,250,797,297,547,47,3,true,true,true,-1.0
1,1,0.5,0.5,false,false,250,300,200,250,-50,-50,50,true,true,true,-1.0
1,1,0.5,0.5,false,false,300,850,250,800,-50,-50,50,true,true,true,-1.0
1,1,0.5,0.5,false,false,250,200,250,200,0,0,0,true,true,true,-1.0
1,1,0.5,0.5,false,false,250,850,250,850,0,0,0,true,true,true,-1.0
1,1,0.5,0.5,false,false,300,350,799,399,499,49,1,true,true,true,-1.0
1,1,0.5,0.5,false,false,250,300,247,297,-3,-3,3,true,true,true,-1.0
1,1,0.5,0.5,false,false,300,250,799,349,499,99,1,true,true,true,-1.0
1,1,0.5,0.5,false,false,250,300,899,799,649,499,1,true,true,true,-1.0
1,1,0.5,0.5,false,false,850,200,847,197,-3,-3,3,true,true,true,-1.0
1,1,0.5,0.5,false,false,200,200,200,200,0,0,0,true,true,true,-1.0
1,1,0.5,0.5,false,false,350,850,300,800,-50,-50,50,true,true,true,-1.0
1,2,0.5,0.5,false,true,200,850,199,849,-1,-1,1,true,true,true,681.604
1,2,0.5,0.5,false,true,850,300,896,796,46,496,4,true,true,true,-1.0
1,2,0.5,0.5,false,true,850,300,898,798,48,498,2,true,true,true,-1.0
1,2,0.5,0.5,false,true,350,250,399,799,49,549,1,true,true,true,-1.0
1,2,0.5,0.5,false,true,300,200,286,186,-14,-14,14,true,true,true,-1.0
1,2,0.5,0.5,false,true,300,200,797,247,497,47,3,true,true,true,-1.0
1,2,0.5,0.5,false,true,250,850,797,897,547,47,3,true,true,true,-1.0
1,2,0.5,0.5,false,true,250,250,248,248,-2,-2,2,true,true,true,-1.0
1,2,0.5,0.5,false,true,250,250,297,297,47,47,3,true,true,true,-1.0
1,2,0.5,0.5,false,true,300,200,262,162,-38,-38,38,true,true,true,-1.0
1,2,0.5,0.5,false,true,300,200,849,899,549,699,1,true,true,true,-1.0
1,2,0.5,0.5,false,true,250,850,248,848,-2,-2,2,true,true,true,-1.0
1,2,0.5,0.5,false,true,200,850,198,848,-2,-2,2,true,true,true,-1.0
1,2,0.5,0.5,false,true,300,250,799,299,499,49,1,true,true,true,-1.0
1,2,0.5,0.5,false,true,250,300,799,349,549,49,1,true,true,true,-1.0
1,2,0.5,0.5,false,true,300,300,300,300,0,0,0,true,true,true,-1.0
1,2,0.5,0.5,false,true,300,200,250,150,-50,-50,50,false,false,false,-1.0
1,2,0.5,0.5,false,true,200,200,200,200,0,0,0,true,true,true,-1.0
1,2,0.5,0.5,false,true,850,300,840,290,-10,-10,10,true,true,true,-1.0
1,2,0.5,0.5,false,true,850,300,898,798,48,498,2,true,true,true,-1.0
1,2,0.5,0.5,false,false,250,300,200,250,-50,-50,50,false,false,false,72.801
1,2,0.5,0.5,false,false,200,300,199,299,-1,-1,1,true,true,true,-1.0
1,2,0.5,0.5,false,false,900,250,892,242,-8,-8,8,true,true,true,-1.0
1,2,0.5,0.5,false,false,300,850,298,848,-2,-2,2,true,true,true,-1.0
1,2,0.5,0.5,false,false,200,350,200,350,0,0,0,true,true,true,-1.0
1,2,0.5,0.5,false,false,300,300,898,798,598,498,2,true,true,true,-1.0
1,2,0.5,0.5,false,false,300,850,797,897,497,47,3,true,true,true,-1.0
1,2,0.5,0.5,false,false,200,300,198,298,-2,-2,2,true,true,true,-1.0
1,2,0.5,0.5,false,false,350,300,396,796,46,496,4,true,true,true,-1.0
1,2,0.5,0.5,false,false,300,250,349,349,49,99,1,true,true,true,-1.0
1,2,0.5,0.5,false,false,250,200,298,798,48,598,2,true,true,true,-1.0
1,2,0.5,0.5,false,false,300,350,751,351,451,1,49,true,true,true,-1.0
1,2,0.5,0.5,false,false,300,850,300,850,0,0,0,true,true,true,-1.0
1,2,0.5,0.5,false,false,250,300,200,250,-50,-50,50,false,false,false,-1.0
1,2,0.5,0.5,false,false,850,300,848,298,-2,-2,2,true,true,true,-1.0
1,2,0.5,0.5,false,false,200,850,249,899,49,49,1,true,true,true,-1.0
1,2,0.5,0.5,false,false,350,300,349,299,-1,-1,1,true,true,true,-1.0
1,2,0.5,0.5,false,false,300,250,286,236,-14,-14,14,true,true,true,-1.0
1,2,0.5,0.5,false,false,250,250,200,200,-50,-50,50,false,false,false,-1.0
1,2,0.5,0.5,false,false,350,850,348,848,-2,-2,2,true,true,true,-1.0
2,0,0.5,0.5,true,false,350,250,897,297,547,47,3,true,true,true,549.719
2,0,0.5,0.5,true,false,350,200,350,200,0,0,0,true,true,true,-1.0
2,0,0.5,0.5,true,false,850,350,845,345,-5,-5,5,true,true,true,-1.0
2,0,0.5,0.5,true,false,300,300,295,295,-5,-5,5,true,true,true,-1.0
2,0,0.5,0.5,true,false,300,250,297,247,-3,-3,3,true,true,true,-1.0
2,0,0.5,0.5,true,false,200,250,197,247,-3,-3,3,true,true,true,-1.0
2,0,0.5,0.5,true,false,350,300,345,295,-5,-5,5,false,false,false,-1.0
2,0,0.5,0.5,true,false,200,200,200,200,0,0,0,true,true,true,-1.0
2,0,0.5,0.5,true,false,300,850,297,847,-3,-3,3,true,true,true,-1.0
2,0,0.5,0.5,true,false,850,350,848,348,-2,-2,2,true,true,true,-1.0
2,0,0.5,0.5,true,false,200,850,197,847,-3,-3,3,true,true,true,-1.0
2,0,0.5,0.5,true,false,300,300,297,297,-3,-3,3,true,true,true,-1.0
2,0,0.5,0.5,true,false,250,250,245,245,-5,-5,5,true,true,true,-1.0
2,0,0.5,0.5,true,false,300,200,297,197,-3,-3,3,true,true,true,-1.0
2,0,0.5,0.5,true,false,300,300,797,397,497,97,3,true,true,true,-1.0
2,0,0.5,0.5,true,false,250,850,247,847,-3,-3,3,true,true,true,-1.0
2,0,0.5,0.5,true,false,250,250,247,247,-3,-3,3,true,true,true,-1.0
2,0,0.5,0.5,true,false,850,300,845,295,-5,-5,5,true,true,true,-1.0
2,0,0.5,0.5,true,false,300,850,297,847,-3,-3,3,true,true,true,-1.0
2,0,0.5,0.5,true,false,850,250,850,250,0,0,0,true,true,true,-1.0
2,0,0.5,0.5,false,false,850,300,899,799,49,499,1,true,true,true,93.357
2,0,0.5,0.5,false,false,200,850,197,847,-3,-3,3,true,true,true,-1.0
2,0,0.5,0.5,false,false,350,200,397,247,47,47,3,true,true,true,-1.0
2,0,0.5,0.5,false,false,350,250,350,250,0,0,0,true,true,true,-1.0
2,0,0.5,0.5,false,false,850,300,845,295,-5,-5,5,true,true,true,-1.0
2,0,0.5,0.5,false,false,300,850,297,847,-3,-3,3,true,true,true,-1.0
2,0,0.5,0.5,false,false,200,300,248,798,48,498,2,true,true,true,-1.0
2,0,0.5,0.5,false,false,900,300,897,297,-3,-3,3,true,true,true,-1.0
2,0,0.5,0.5,false,false,200,350,296,896,96,546,4,true,true,true,-1.0
2,0,0.5,0.5,false,false,200,250,200,250,0,0,0,true,true,true,-1.0
2,0,0.5,0.5,false,false,850,350,850,350,0,0,0,true,true,true,-1.0
2,0,0.5,0.5,false,false,850,850,847,847,-3,-3,3,true,true,true,-1.0
2,0,0.5,0.5,false,false,250,850,245,845,-5,-5,5,true,true,true,-1.0
2,0,0.5,0.5,false,false,850,200,850,200,0,0,0,true,true,true,-1.0
2,0,0.5,0.5,false,false,300,350,295,345,-5,-5,5,true,true,true,-1.0
2,0,0.5,0.5,false,false,250,250,247,247,-3,-3,3,true,true,true,-1.0
2,0,0.5,0.5,false,false,850,850,847,847,-3,-3,3,true,true,true,-1.0
2,0,0.5,0.5,false,false,300,300,797,347,497,47,3,true,true,true,-1.0
2,0,0.5,0.5,false,false,200,250,195,245,-5,-5,5,false,false,false,-1.0
2,0,0.5,0.5,false,false,300,350,797,947,497,597,3,true,true,true,-1.0
2,1,0.5,0.5,true,false,250,850,249,849,-1,-1,1,true,true,true,686.313
2,1,0.5,0.5,true,false,250,200,797,247,547,47,3,true,true,true,-1.0
2,1,0.5,0.5,true,false,200,250,899,799,699,549,1,true,true,true,-1.0
2,1,0.5,0.5,true,false,300,300,297,297,-3,-3,3,true,true,true,-1.0
2,1,0.5,0.5,true,false,250,300,249,299,-1,-1,1,true,true,true,-1.0
2,1,0.5,0.5,true,false,850,300,898,798,48,498,2,true,true,true,-1.0
2,1,0.5,0.5,true,false,250,250,247,247,-3,-3,3,true,true,true,-1.0
2,1,0.5,0.5,true,false,300,250,297,247,-3,-3,3,true,true,true,-1.0
2,1,0.5,0.5,true,false,200,200,197,197,-3,-3,3,true,true,true,-1.0
2,1,0.5,0.5,true,false,250,300,250,300,0,0,0,true,true,true,-1.0
2,1,0.5,0.5,true,false,200,300,298,348,98,48,2,true,true,true,-1.0
2,1,0.5,0.5,true,false,300,850,297,847,-3,-3,3,true,true,true,-1.0
2,1,0.5,0.5,true,false,300,250,297,247,-3,-3,3,true,true,true,-1.0
2,1,0.5,0.5,true,false,200,300,249,349,49,49,1,true,true,true,-1.0
2,1,0.5,0.5,true,false,200,300,898,798,698,498,2,true,true,true,-1.0
2,1,0.5,0.5,true,false,250,300,798,348,548,48,2,true,true,true,-1.0
2,1,0.5,0.5,true,false,250,200,203,203,-47,3,47,true,true,true,-1.0
2,1,0.5,0.5,true,false,850,250,847,247,-3,-3,3,true,true,true,-1.0
2,1,0.5,0.5,true,false,200,850,199,849,-1,-1,1,true,true,true,-1.0
2,1,0.5,0.5,true,false,300,300,297,297,-3,-3,3,true,true,true,-1.0
2,1,0.5,0.5,false,false,850,300,899,799,49,499,1,true,true,true,108.967
2,1,0.5,0.5,false,false,250,200,250,200,0,0,0,true,true,true,-1.0
2,1,0.5,0.5,false,false,300,200,349,249,49,49,1,true,true,true,-1.0
2,1,0.5,0.5,false,false,350,250,897,847,547,597,3,true,true,true,-1.0
2,1,0.5,0.5,false,false,200,300,197,297,-3,-3,3,true,true,true,-1.0
2,1,0.5,0.5,false,false,350,200,350,200,0,0,0,true,true,true,-1.0
2,1,0.5,0.5,false,false,200,200,200,200,0,0,0,true,true,true,-1.0
2,1,0.5,0.5,false,false,250,300,399,799,149,499,1,true,true,true,-1.0
2,1,0.5,0.5,false,false,300,850,300,850,0,0,0,true,true,true,-1.0
2,1,0.5,0.5,false,false,250,250,298,298,48,48,2,true,false,true,-1.0
2,1,0.5,0.5,false,false,850,300,847,297,-3,-3,3,true,true,true,-1.0
2,1,0.5,0.5,false,false,900,300,949,799,49,499,1,true,true,true,-1.0
2,1,0.5,0.5,false,false,200,200,200,200,0,0,0,true,true,true,-1.0
2,1,0.5,0.5,false,false,250,250,799,399,549,149,1,true,true,true,-1.0
2,1,0.5,0.5,false,false,200,300,248,798,48,498,2,true,true,true,-1.0
2,1,0.5,0.5,false,false,900,350,900,350,0,0,0,true,true,true,-1.0
2,1,0.5,0.5,false,false,200,200,200,200,0,0,0,true,true,true,-1.0
2,1,0.5,0.5,false,false,250,250,299,799,49,549,1,true,true,true,-1.0
2,1,0.5,0.5,false,false,300,300,348,798,48,498,2,true,true,true,-1.0
2,1,0.5,0.5,false,false,250,850,798,898,548,48,2,true,true,true,-1.0
2,2,0.5,0.5,true,true,300,300,299,299,-1,-1,1,true,true,true,487.485
2,2,0.5,0.5,true,true,300,200,399,249,99,49,1,true,true,true,-1.0
2,2,0.5,0.5,true,true,250,300,250,300,0,0,0,true,true,true,-1.0
2,2,0.5,0.5,true,true,350,300,300,250,-50,-50,50,false,false,false,-1.0
2,2,0.5,0.5,true,true,300,350,299,349,-1,-1,1,true,true,true,-1.0
2,2,0.5,0.5,true,true,300,350,299,349,-1,-1,1,true,true,true,-1.0
2,2,0.5,0.5,true,true,250,300,299,799,49,499,1,true,true,true,-1.0
2,2,0.5,0.5,true,true,300,200,300,200,0,0,0,true,true,true,-1.0
2,2,0.5,0.5,true,true,250,300,799,349,549,49,1,true,true,true,-1.0
2,2,0.5,0.5,true,true,200,850,200,850,0,0,0,true,true,true,-1.0
2,2,0.5,0.5,true,true,850,200,850,200,0,0,0,true,true,true,-1.0
2,2,0.5,0.5,true,true,300,200,799,249,499,49,1,true,true,true,-1.0
2,2,0.5,0.5,true,true,200,200,349,799,149,599,1,true,true,true,-1.0
2,2,0.5,0.5,true,true,200,850,199,849,-1,-1,1,true,true,true,-1.0
2,2,0.5,0.5,true,true,300,300,298,298,-2,-2,2,true,true,true,-1.0
2,2,0.5,0.5,true,true,250,200,797,897,547,697,3,true,true,true,-1.0
2,2,0.5,0.5,true,true,350,900,349,899,-1,-1,1,true,true,true,-1.0
2,2,0.5,0.5,true,true,200,850,199,849,-1,-1,1,true,true,true,-1.0
2,2,0.5,0.5,true,true,850,250,849,249,-1,-1,1,true,true,true,-1.0
2,2,0.5,0.5,true,true,350,200,348,198,-2,-2,2,true,true,true,-1.0
2,2,0.5,0.5,true,false,850,850,849,849,-1,-1,1,true,true,true,729.166
2,2,0.5,0.5,true,false,250,250,248,248,-2,-2,2,true,true,true,-1.0
2,2,0.5,0.5,true,false,300,250,797,347,497,97,3,true,true,true,-1.0
2,2,0.5,0.5,true,false,200,250,198,248,-2,-2,2,true,true,true,-1.0
2,2,0.5,0.5,true,false,250,300,249,299,-1,-1,1,true,true,true,-1.0
2,2,0.5,0.5,true,false,200,300,799,349,599,49,1,true,true,true,-1.0
2,2,0.5,0.5,true,false,250,300,849,849,599,549,1,true,true,true,-1.0
2,2,0.5,0.5,true,false,300,300,299,299,-1,-1,1,true,true,true,-1.0
2,2,0.5,0.5,true,false,300,300,349,799,49,499,1,true,true,true,-1.0
2,2,0.5,0.5,true,false,250,300,344,344,94,44,6,true,true,true,-1.0
2,2,0.5,0.5,true,false,200,200,299,799,99,599,1,true,true,true,-1.0
2,2,0.5,0.5,true,false,850,250,846,246,-4,-4,4,true,true,true,-1.0
2,2,0.5,0.5,true,false,850,250,850,250,0,0,0,true,true,true,-1.0
2,2,0.5,0.5,true,false,300,300,299,299,-1,-1,1,true,true,true,-1.0
2,2,0.5,0.5,true,false,250,850,249,849,-1,-1,1,true,true,true,-1.0
2,2,0.5,0.5,true,false,250,250,248,248,-2,-2,2,true,true,true,-1.0
2,2,0.5,0.5,true,false,300,300,299,299,-1,-1,1,true,true,true,-1.0
2,2,0.5,0.5,true,false,300,300,299,299,-1,-1,1,true,true,true,-1.0
2,2,0.5,0.5,true,false,300,300,798,348,498,48,2,true,true,true,-1.0
2,2,0.5,0.5,true,false,300,850,300,850,0,0,0,true,true,true,-1.0
2,2,0.5,0.5,false,true,200,200,200,200,0,0,0,true,true,true,173.462
2,2,0.5,0.5,false,true,300,250,299,249,-1,-1,1,true,true,true,-1.0
2,2,0.5,0.5,false,true,250,250,298,298,48,48,2,true,true,true,-1.0
2,2,0.5,0.5,false,true,350,250,349,249,-1,-1,1,true,true,true,-1.0
2,2,0.5,0.5,false,true,250,250,299,799,49,549,1,true,true,true,-1.0
2,2,0.5,0.5,false,true,850,300,898,798,48,498,2,true,true,true,-1.0
2,2,0.5,0.5,false,true,250,200,250,200,0,0,0,true,true,true,-1.0
2,2,0.5,0.5,false,true,350,350,349,349,-1,-1,1,true,true,true,-1.0
2,2,0.5,0.5,false,true,250,200,899,849,649,649,1,true,true,true,-1.0
2,2,0.5,0.5,false,true,850,850,849,849,-1,-1,1,true,true,true,-1.0
2,2,0.5,0.5,false,true,200,300,347,797,147,497,3,true,true,true,-1.0
2,2,0.5,0.5,false,true,350,850,349,849,-1,-1,1,true,true,true,-1.0
2,2,0.5,0.5,false,true,300,250,899,299,599,49,1,true,true,true,-1.0
2,2,0.5,0.5,false,true,900,250,900,250,0,0,0,true,true,true,-1.0
2,2,0.5,0.5,false,true,200,300,248,798,48,498,2,true,true,true,-1.0
2,2,0.5,0.5,false,true,200,850,198,848,-2,-2,2,true,true,true,-1.0
2,2,0.5,0.5,false,true,300,250,296,246,-4,-4,4,true,true,true,-1.0
2,2,0.5,0.5,false,true,850,300,849,299,-1,-1,1,true,true,true,-1.0
2,2,0.5,0.5,false,true,250,850,249,849,-1,-1,1,true,true,true,-1.0
2,2,0.5,0.5,false,true,850,250,850,250,0,0,0,true,true,true,-1.0
2,2,0.5,0.5,false,false,300,300,348,798,48,498,2,true,true,true,110.181
2,2,0.5,0.5,false,false,850,850,849,849,-1,-1,1,true,true,true,-1.0
2,2,0.5,0.5,false,false,350,250,349,249,-1,-1,1,true,true,true,-1.0
2,2,0.5,0.5,false,false,200,850,798,898,598,48,2,true,true,true,-1.0
2,2,0.5,0.5,false,false,300,250,789,339,489,89,11,true,true,true,-1.0
2,2,0.5,0.5,false,false,200,250,797,297,597,47,3,true,true,true,-1.0
2,2,0.5,0.5,false,false,300,300,300,300,0,0,0,true,true,true,-1.0
2,2,0.5,0.5,false,false,250,250,249,249,-1,-1,1,true,true,true,-1.0
2,2,0.5,0.5,false,false,250,250,787,387,537,137,13,true,true,true,-1.0
2,2,0.5,0.5,false,false,200,850,199,849,-1,-1,1,true,true,true,-1.0
2,2,0.5,0.5,false,false,250,300,248,298,-2,-2,2,true,true,true,-1.0
2,2,0.5,0.5,false,false,300,300,798,348,498,48,2,true,true,true,-1.0
2,2,0.5,0.5,false,false,200,850,199,849,-1,-1,1,true,true,true,-1.0
2,2,0.5,0.5,false,false,250,300,249,299,-1,-1,1,true,true,true,-1.0
2,2,0.5,0.5,false,false,350,250,348,248,-2,-2,2,true,true,true,-1.0
2,2,0.5,0.5,false,false,850,900,849,899,-1,-1,1,true,true,true,-1.0
2,2,0.5,0.5,false,false,850,850,850,850,0,0,0,true,true,true,-1.0
2,2,0.5,0.5,false,false,300,250,797,297,497,47,3,true,true,true,-1.0
2,2,0.5,0.5,false,false,250,300,249,299,-1,-1,1,true,true,true,-1.0
2,2,0.5,0.5,false,false,350,300,349,299,-1,-1,1,true,true,true,-1.0
0,0,0.5,0.5,false,false,200,850,197,847,-3,-3,3,true,true,true,0.186
0,0,0.5,0.5,false,false,850,200,848,198,-2,-2,2,true,true,true,-1.0
0,0,0.5,0.5,false,false,350,250,347,247,-3,-3,3,true,true,true,-1.0
0,0,0.5,0.5,false,false,200,250,197,247,-3,-3,3,false,false,false,-1.0
0,0,0.5,0.5,false,false,200,850,197,847,-3,-3,3,false,false,false,-1.0
0,0,0.5,0.5,false,false,200,900,197,897,-3,-3,3,true,true,true,-1.0
0,0,0.5,0.5,false,false,250,850,247,847,-3,-3,3,true,true,true,-1.0
0,0,0.5,0.5,false,false,300,200,296,196,-4,-4,4,true,true,true,-1.0
0,0,0.5,0.5,false,false,900,300,896,296,-4,-4,4,true,true,true,-1.0
0,0,0.5,0.5,false,false,300,250,799,399,499,149,1,true,true,true,-1.0
0,0,0.5,0.5,false,false,250,850,298,898,48,48,2,true,true,true,-1.0
0,0,0.5,0.5,false,false,200,250,197,247,-3,-3,3,true,true,true,-1.0
0,0,0.5,0.5,false,false,250,850,799,899,549,49,1,true,true,true,-1.0
0,0,0.5,0.5,false,false,300,250,297,247,-3,-3,3,true,true,true,-1.0
0,0,0.5,0.5,false,false,300,200,897,297,597,97,3,true,true,true,-1.0
0,0,0.5,0.5,false,false,250,200,248,198,-2,-2,2,true,true,true,-1.0
0,0,0.5,0.5,false,false,850,200,846,196,-4,-4,4,true,true,true,-1.0
0,0,0.5,0.5,false,false,250,200,247,197,-3,-3,3,true,true,true,-1.0
0,0,0.5,0.5,false,false,250,300,247,297,-3,-3,3,true,true,true,-1.0
0,0,0.5,0.5,false,false,350,250,397,797,47,547,3,true,true,true,-1.0
0,1,0.5,0.5,false,false,250,850,246,846,-4,-4,4,true,true,true,0.272
0,1,0.5,0.5,false,false,850,200,846,196,-4,-4,4,true,true,true,-1.0
0,1,0.5,0.5,false,false,300,850,797,897,497,47,3,true,true,true,-1.0
0,1,0.5,0.5,false,false,200,850,196,846,-4,-4,4,true,true,true,-1.0
0,1,0.5,0.5,false,false,300,200,296,196,-4,-4,4,false,false,false,-1.0
0,1,0.5,0.5,false,false,300,850,797,897,497,47,3,true,true,true,-1.0
0,1,0.5,0.5,false,false,300,300,299,299,-1,-1,1,true,true,true,-1.0
0,1,0.5,0.5,false,false,300,250,296,246,-4,-4,4,true,true,true,-1.0
0,1,0.5,0.5,false,false,850,300,846,296,-4,-4,4,true,true,true,-1.0
0,1,0.5,0.5,false,false,250,300,247,297,-3,-3,3,true,true,true,-1.0
0,1,0.5,0.5,false,false,200,200,196,196,-4,-4,4,true,true,true,-1.0
0,1,0.5,0.5,false,false,300,200,296,196,-4,-4,4,false,false,false,-1.0
0,1,0.5,0.5,false,false,250,200,799,949,549,749,1,true,true,true,-1.0
0,1,0.5,0.5,false,false,200,350,197,347,-3,-3,3,true,true,true,-1.0
0,1,0.5,0.5,false,false,350,300,899,849,549,549,1,true,true,true,-1.0
0,1,0.5,0.5,false,false,850,300,846,296,-4,-4,4,true,true,true,-1.0
0,1,0.5,0.5,false,false,300,850,297,847,-3,-3,3,true,true,true,-1.0
0,1,0.5,0.5,false,false,300,300,348,798,48,498,2,true,true,true,-1.0
0,1,0.5,0.5,false,false,300,200,799,899,499,699,1,true,true,true,-1.0
0,1,0.5,0.5,false,false,200,200,199,199,-1,-1,1,true,true,true,-1.0
0,2,0.5,0.5,false,true,850,200,846,196,-4,-4,4,true,true,true,319.871
0,2,0.5,0.5,false,true,200,300,196,296,-4,-4,4,false,false,false,-1.0
0,2,0.5,0.5,false,true,850,200,846,196,-4,-4,4,false,false,false,-1.0
0,2,0.5,0.5,false,true,200,250,248,298,48,48,2,true,false,true,-1.0
0,2,0.5,0.5,false,true,850,850,846,846,-4,-4,4,true,true,true,-1.0
0,2,0.5,0.5,false,true,200,300,199,299,-1,-1,1,true,true,true,-1.0
0,2,0.5,0.5,false,true,900,850,899,849,-1,-1,1,true,true,true,-1.0
0,2,0.5,0.5,false,true,850,200,846,196,-4,-4,4,true,true,true,-1.0
0,2,0.5,0.5,false,true,200,350,248,948,48,598,2,true,true,true,-1.0
0,2,0.5,0.5,false,true,850,200,846,196,-4,-4,4,false,false,false,-1.0
0,2,0.5,0.5,false,true,250,300,298,798,48,498,2,true,true,true,-1.0
0,2,0.5,0.5,false,true,200,850,248,898,48,48,2,true,true,true,-1.0
0,2,0.5,0.5,false,true,200,300,298,798,98,498,2,true,true,true,-1.0
0,2,0.5,0.5,false,true,900,250,898,248,-2,-2,2,true,true,true,-1.0
0,2,0.5,0.5,false,true,250,300,298,898,48,598,2,true,true,true,-1.0
0,2,0.5,0.5,false,true,350,200,897,297,547,97,3,true,true,true,-1.0
0,2,0.5,0.5,false,true,300,900,297,897,-3,-3,3,true,true,true,-1.0
0,2,0.5,0.5,false,true,300,250,348,798,48,548,2,true,true,true,-1.0
0,2,0.5,0.5,false,true,350,250,349,249,-1,-1,1,true,true,true,-1.0
0,2,0.5,0.5,false,true,300,250,348,348,48,98,2,true,true,true,-1.0
0,2,0.5,0.5,false,false,250,200,847,297,597,97,3,true,true,true,76.349
0,2,0.5,0.5,false,false,300,200,296,196,-4,-4,4,false,false,false,-1.0
0,2,0.5,0.5,false,false,300,300,348,798,48,498,2,true,true,true,-1.0
0,2,0.5,0.5,false,false,200,300,199,299,-1,-1,1,true,true,true,-1.0
0,2,0.5,0.5,false,false,300,200,799,299,499,99,1,true,true,true,-1.0
0,2,0.5,0.5,false,false,850,300,846,296,-4,-4,4,true,true,true,-1.0
0,2,0.5,0.5,false,false,300,300,296,296,-4,-4,4,true,true,true,-1.0
0,2,0.5,0.5,false,false,300,850,297,847,-3,-3,3,true,true,true,-1.0
0,2,0.5,0.5,false,false,250,200,249,199,-1,-1,1,true,true,true,-1.0
0,2,0.5,0.5,false,false,200,200,396,796,196,596,4,true,true,true,-1.0
0,2,0.5,0.5,false,false,200,850,199,849,-1,-1,1,true,true,true,-1.0
0,2,0.5,0.5,false,false,300,300,299,299,-1,-1,1,true,true,true,-1.0
0,2,0.5,0.5,false,false,200,200,199,199,-1,-1,1,true,true,true,-1.0
0,2,0.5,0.5,false,false,850,300,846,296,-4,-4,4,true,true,true,-1.0
0,2,0.5,0.5,false,false,850,850,849,849,-1,-1,1,true,true,true,-1.0
0,2,0.5,0.5,false,false,250,300,348,798,98,498,2,true,true,true,-1.0
0,2,0.5,0.5,false,false,900,300,948,798,48,498,2,true,true,true,-1.0
0,2,0.5,0.5,false,false,300,350,296,346,-4,-4,4,true,true,true,-1.0
0,2,0.5,0.5,false,false,200,300,197,297,-3,-3,3,true,true,true,-1.0
0,2,0.5,0.5,false,false,850,300,848,298,-2,-2,2,true,true,true,-1.0
1,0,0.5,0.5,false,false,300,250,799,299,499,49,1,true,true,true,0.314
1,0,0.5,0.5,false,false,300,300,948,798,648,498,2,true,true,true,-1.0
1,0,0.5,0.5,false,false,300,850,799,899,499,49,1,true,true,true,-1.0
1,0,0.5,0.5,false,false,850,300,847,297,-3,-3,3,true,true,true,-1.0
1,0,0.5,0.5,false,false,250,350,245,345,-5,-5,5,true,true,true,-1.0
1,0,0.5,0.5,false,false,300,250,297,247,-3,-3,3,true,true,true,-1.0
1,0,0.5,0.5,false,false,250,350,247,347,-3,-3,3,true,true,true,-1.0
1,0,0.5,0.5,false,false,250,850,247,847,-3,-3,3,true,true,true,-1.0
1,0,0.5,0.5,false,false,250,250,247,247,-3,-3,3,true,true,true,-1.0
1,0,0.5,0.5,false,false,900,200,900,200,0,0,0,true,true,true,-1.0
1,0,0.5,0.5,false,false,300,200,295,195,-5,-5,5,true,true,true,-1.0
1,0,0.5,0.5,false,false,200,850,197,847,-3,-3,3,true,true,true,-1.0
1,0,0.5,0.5,false,false,850,300,898,798,48,498,2,true,true,true,-1.0
1,0,0.5,0.5,false,false,250,850,247,847,-3,-3,3,true,true,true,-1.0
1,0,0.5,0.5,false,false,250,850,247,847,-3,-3,3,true,true,true,-1.0
1,0,0.5,0.5,false,false,850,850,850,850,0,0,0,true,true,true,-1.0
1,0,0.5,0.5,false,false,200,250,799,899,599,649,1,true,true,true,-1.0
1,0,0.5,0.5,false,false,850,300,845,295,-5,-5,5,true,true,true,-1.0
1,0,0.5,0.5,false,false,300,850,297,847,-3,-3,3,true,true,true,-1.0
1,0,0.5,0.5,false,false,350,850,347,847,-3,-3,3,true,true,true,-1.0
1,1,0.5,0.5,false,false,250,200,200,150,-50,-50,50,false,false,false,1.144
1,1,0.5,0.5,false,false,850,850,850,850,0,0,0,true,true,true,-1.0
1,1,0.5,0.5,false,false,850,200,800,150,-50,-50,50,false,false,false,-1.0
1,1,0.5,0.5,false,false,300,300,297,297,-3,-3,3,true,true,true,-1.0
1,1,0.5,0.5,false,false,200,300,150,250,-50,-50,50,false,false,false,-1.0
1,1,0.5,0.5,false,false,350,200,300,150,-50,-50,50,false,false,false,-1.0
1,1,0.5,0.5,false,false,300,850,799,899,499,49,1,true,true,true,-1.0
1,1,0.5,0.5,false,false,200,350,150,300,-50,-50,50,false,false,false,-1.0
1,1,0.5,0.5,false,false,850,850,850,850,0,0,0,true,true,true,-1.0
1,1,0.5,0.5,false,false,300,200,300,200,0,0,0,true,true,true,-1.0
1,1,0.5,0.5,false,false,300,300,349,799,49,499,1,true,true,true,-1.0
1,1,0.5,0.5,false,false,350,250,300,200,-50,-50,50,true,true,true,-1.0
1,1,0.5,0.5,false,false,300,300,295,295,-5,-5,5,true,true,true,-1.0
1,1,0.5,0.5,false,false,350,900,300,850,-50,-50,50,true,true,true,-1.0
1,1,0.5,0.5,false,false,250,350,247,347,-3,-3,3,true,true,true,-1.0
1,1,0.5,0.5,false,false,250,200,247,197,-3,-3,3,true,true,true,-1.0
1,1,0.5,0.5,false,false,250,250,200,200,-50,-50,50,true,true,true,-1.0
1,1,0.5,0.5,false,false,850,300,848,298,-2,-2,2,true,true,true,-1.0
1,1,0.5,0.5,false,false,850,300,898,798,48,498,2,true,true,true,-1.0
1,1,0.5,0.5,false,false,300,250,799,349,499,99,1,true,true,true,-1.0
1,2,0.5,0.5,false,true,250,250,246,246,-4,-4,4,true,true,true,433.017
1,2,0.5,0.5,false,true,200,250,199,249,-1,-1,1,true,true,true,-1.0
1,2,0.5,0.5,false,true,200,200,248,798,48,598,2,true,true,true,-1.0
1,2,0.5,0.5,false,true,300,250,797,347,497,97,3,true,true,true,-1.0
1,2,0.5,0.5,false,true,850,300,848,298,-2,-2,2,true,true,true,-1.0
1,2,0.5,0.5,false,true,300,850,298,848,-2,-2,2,true,true,true,-1.0
1,2,0.5,0.5,false,true,300,200,250,150,-50,-50,50,false,false,false,-1.0
1,2,0.5,0.5,false,true,250,300,898,798,648,498,2,true,true,true,-1.0
1,2,0.5,0.5,false,true,200,200,198,198,-2,-2,2,true,true,true,-1.0
1,2,0.5,0.5,false,true,300,850,797,897,497,47,3,true,true,true,-1.0
1,2,0.5,0.5,false,true,300,850,298,848,-2,-2,2,true,true,true,-1.0
1,2,0.5,0.5,false,true,850,250,850,250,0,0,0,true,true,true,-1.0
1,2,0.5,0.5,false,true,300,200,250,150,-50,-50,50,false,false,false,-1.0
1,2,0.5,0.5,false,true,300,850,298,848,-2,-2,2,true,true,true,-1.0
1,2,0.5,0.5,false,true,250,250,248,248,-2,-2,2,true,true,true,-1.0
1,2,0.5,0.5,false,true,300,250,799,349,499,99,1,true,true,true,-1.0
1,2,0.5,0.5,false,true,350,200,949,299,599,99,1,true,true,true,-1.0
1,2,0.5,0.5,false,true,200,350,198,348,-2,-2,2,true,true,true,-1.0
1,2,0.5,0.5,false,true,200,850,198,848,-2,-2,2,true,true,true,-1.0
1,2,0.5,0.5,false,true,300,300,849,899,549,599,1,true,true,true,-1.0
1,2,0.5,0.5,false,false,300,300,799,399,499,99,1,true,true,true,146.903
1,2,0.5,0.5,false,false,350,200,350,200,0,0,0,true,true,true,-1.0
1,2,0.5,0.5,false,false,250,350,200,300,-50,-50,50,false,false,false,-1.0
1,2,0.5,0.5,false,false,850,250,848,248,-2,-2,2,true,true,true,-1.0
1,2,0.5,0.5,false,false,300,200,797,297,497,97,3,true,true,true,-1.0
1,2,0.5,0.5,false,false,250,300,250,300,0,0,0,true,true,true,-1.0
1,2,0.5,0.5,false,false,250,200,298,798,48,598,2,true,true,true,-1.0
1,2,0.5,0.5,false,false,300,200,300,200,0,0,0,true,true,true,-1.0
1,2,0.5,0.5,false,false,200,300,847,847,647,547,3,true,true,true,-1.0
1,2,0.5,0.5,false,false,300,300,799,899,499,599,1,true,true,true,-1.0
1,2,0.5,0.5,false,false,350,300,350,300,0,0,0,true,true,true,-1.0
1,2,0.5,0.5,false,false,200,250,247,297,47,47,3,true,true,true,-1.0
1,2,0.5,0.5,false,false,850,250,850,250,0,0,0,true,true,true,-1.0
1,2,0.5,0.5,false,false,300,250,851,251,551,1,49,true,true,true,-1.0
1,2,0.5,0.5,false,false,250,900,248,898,-2,-2,2,true,true,true,-1.0
1,2,0.5,0.5,false,false,250,200,799,299,549,99,1,true,false,true,-1.0
1,2,0.5,0.5,false,false,300,850,299,849,-1,-1,1,true,true,true,-1.0
1,2,0.5,0.5,false,false,200,850,199,849,-1,-1,1,true,true,true,-1.0
1,2,0.5,0.5,false,false,200,250,150,200,-50,-50,50,false,false,false,-1.0
1,2,0.5,0.5,false,false,300,250,335,285,35,35,15,true,true,true,-1.0
2,0,0.5,0.5,true,false,300,300,297,297,-3,-3,3,true,true,true,623.698
2,0,0.5,0.5,true,false,300,250,797,297,497,47,3,true,true,true,-1.0
2,0,0.5,0.5,true,false,300,300,897,347,597,47,3,true,true,true,-1.0
2,0,0.5,0.5,true,false,300,300,396,796,96,496,4,true,true,true,-1.0
2,0,0.5,0.5,true,false,200,900,197,897,-3,-3,3,true,true,true,-1.0
2,0,0.5,0.5,true,false,300,200,797,247,497,47,3,true,true,true,-1.0
2,0,0.5,0.5,true,false,300,350,295,345,-5,-5,5,true,true,true,-1.0
2,0,0.5,0.5,true,false,200,350,195,345,-5,-5,5,true,true,true,-1.0
2,0,0.5,0.5,true,false,350,250,350,250,0,0,0,true,true,true,-1.0
2,0,0.5,0.5,true,false,200,200,197,197,-3,-3,3,true,true,true,-1.0
2,0,0.5,0.5,true,false,250,350,797,397,547,47,3,true,true,true,-1.0
2,0,0.5,0.5,true,false,300,850,297,847,-3,-3,3,true,true,true,-1.0
2,0,0.5,0.5,true,false,250,200,799,249,549,49,1,true,true,true,-1.0
2,0,0.5,0.5,true,false,300,300,348,798,48,498,2,true,true,true,-1.0
2,0,0.5,0.5,true,false,250,300,898,798,648,498,2,true,true,true,-1.0
2,0,0.5,0.5,true,false,850,250,845,245,-5,-5,5,true,true,true,-1.0
2,0,0.5,0.5,true,false,250,350,247,347,-3,-3,3,true,true,true,-1.0
2,0,0.5,0.5,true,false,250,250,247,247,-3,-3,3,true,true,true,-1.0
2,0,0.5,0.5,true,false,200,200,195,195,-5,-5,5,true,true,true,-1.0
2,0,0.5,0.5,true,false,200,200,197,197,-3,-3,3,true,true,true,-1.0
2,0,0.5,0.5,false,false,200,250,799,299,599,49,1,true,true,true,75.678
2,0,0.5,0.5,false,false,200,250,200,250,0,0,0,true,true,true,-1.0
2,0,0.5,0.5,false,false,200,300,197,297,-3,-3,3,true,true,true,-1.0
2,0,0.5,0.5,false,false,300,350,797,947,497,597,3,true,true,true,-1.0
2,0,0.5,0.5,false,false,300,250,797,347,497,97,3,true,true,true,-1.0
2,0,0.5,0.5,false,false,200,200,200,200,0,0,0,true,true,true,-1.0
2,0,0.5,0.5,false,false,200,200,798,248,598,48,2,true,true,true,-1.0
2,0,0.5,0.5,false,false,250,850,247,847,-3,-3,3,false,false,false,-1.0
2,0,0.5,0.5,false,false,250,300,247,297,-3,-3,3,true,true,true,-1.0
2,0,0.5,0.5,false,false,300,200,799,349,499,149,1,true,true,true,-1.0
2,0,0.5,0.5,false,false,850,350,845,345,-5,-5,5,true,true,true,-1.0
2,0,0.5,0.5,false,false,300,300,296,296,-4,-4,4,true,true,true,-1.0
2,0,0.5,0.5,false,false,850,300,846,296,-4,-4,4,true,true,true,-1.0
2,0,0.5,0.5,false,false,300,850,298,848,-2,-2,2,true,true,true,-1.0
2,0,0.5,0.5,false,false,200,300,248,348,48,48,2,true,true,true,-1.0
2,0,0.5,0.5,false,false,350,200,397,247,47,47,3,true,true,true,-1.0
2,0,0.5,0.5,false,false,300,250,300,250,0,0,0,true,true,true,-1.0
2,0,0.5,0.5,false,false,200,200,197,197,-3,-3,3,true,true,true,-1.0
2,0,0.5,0.5,false,false,200,850,197,847,-3,-3,3,true,true,true,-1.0
2,0,0.5,0.5,false,false,300,850,297,847,-3,-3,3,true,true,true,-1.0
2,1,0.5,0.5,true,false,300,300,297,297,-3,-3,3,true,true,true,690.479
2,1,0.5,0.5,true,false,850,350,847,347,-3,-3,3,true,true,true,-1.0
2,1,0.5,0.5,true,false,850,300,898,798,48,498,2,true,true,true,-1.0
2,1,0.5,0.5,true,false,300,200,300,200,0,0,0,true,true,true,-1.0
2,1,0.5,0.5,true,false,250,250,898,798,648,548,2,true,true,true,-1.0
2,1,0.5,0.5,true,false,300,350,300,350,0,0,0,true,true,true,-1.0
2,1,0.5,0.5,true,false,200,850,197,847,-3,-3,3,false,false,false,-1.0
2,1,0.5,0.5,true,false,200,300,249,349,49,49,1,true,true,true,-1.0
2,1,0.5,0.5,true,false,300,200,849,249,549,49,1,true,true,true,-1.0
2,1,0.5,0.5,true,false,200,250,197,247,-3,-3,3,true,true,true,-1.0
2,1,0.5,0.5,true,false,900,300,897,297,-3,-3,3,true,true,true,-1.0
2,1,0.5,0.5,true,false,250,300,298,798,48,498,2,true,true,true,-1.0
2,1,0.5,0.5,true,false,300,350,300,350,0,0,0,true,true,true,-1.0
2,1,0.5,0.5,true,false,250,200,348,298,98,98,2,true,true,true,-1.0
2,1,0.5,0.5,true,false,200,300,197,297,-3,-3,3,true,true,true,-1.0
2,1,0.5,0.5,true,false,900,250,900,250,0,0,0,true,true,true,-1.0
2,1,0.5,0.5,true,false,300,300,297,297,-3,-3,3,true,true,true,-1.0
2,1,0.5,0.5,true,false,300,300,297,297,-3,-3,3,true,true,true,-1.0
2,1,0.5,0.5,true,false,250,250,250,250,0,0,0,true,true,true,-1.0
2,1,0.5,0.5,true,false,900,300,948,798,48,498,2,true,true,true,-1.0
2,1,0.5,0.5,false,false,850,250,847,247,-3,-3,3,true,true,true,109.111
2,1,0.5,0.5,false,false,850,300,898,798,48,498,2,true,true,true,-1.0
2,1,0.5,0.5,false,false,250,300,298,798,48,498,2,true,true,true,-1.0
2,1,0.5,0.5,false,false,300,850,297,847,-3,-3,3,true,true,true,-1.0
2,1,0.5,0.5,false,false,300,250,349,799,49,549,1,true,true,true,-1.0
2,1,0.5,0.5,false,false,850,350,847,347,-3,-3,3,true,true,true,-1.0
2,1,0.5,0.5,false,false,200,350,298,898,98,548,2,true,true,true,-1.0
2,1,0.5,0.5,false,false,300,300,297,297,-3,-3,3,true,true,true,-1.0
2,1,0.5,0.5,false,false,300,200,300,200,0,0,0,true,true,true,-1.0
2,1,0.5,0.5,false,false,900,200,949,249,49,49,1,true,true,true,-1.0
2,1,0.5,0.5,false,false,200,200,197,197,-3,-3,3,true,true,true,-1.0
2,1,0.5,0.5,false,false,200,350,199,349,-1,-1,1,true,true,true,-1.0
2,1,0.5,0.5,false,false,850,350,850,350,0,0,0,true,true,true,-1.0
2,1,0.5,0.5,false,false,300,300,318,768,18,468,32,true,true,true,-1.0
2,1,0.5,0.5,false,false,250,250,247,247,-3,-3,3,true,true,true,-1.0
2,1,0.5,0.5,false,false,300,250,797,897,497,647,3,true,true,true,-1.0
2,1,0.5,0.5,false,false,250,200,297,247,47,47,3,true,true,true,-1.0
2,1,0.5,0.5,false,false,250,300,247,297,-3,-3,3,true,true,true,-1.0
2,1,0.5,0.5,false,false,200,300,206,756,6,456,44,true,true,true,-1.0
2,1,0.5,0.5,false,false,250,850,247,847,-3,-3,3,true,true,true,-1.0
2,2,0.5,0.5,true,true,250,300,249,299,-1,-1,1,true,true,true,492.423
2,2,0.5,0.5,true,true,300,200,899,249,599,49,1,true,true,true,-1.0
2,2,0.5,0.5,true,true,350,300,346,296,-4,-4,4,true,true,true,-1.0
2,2,0.5,0.5,true,true,200,250,299,299,99,49,1,true,true,true,-1.0
2,2,0.5,0.5,true,true,250,300,298,348,48,48,2,true,true,true,-1.0
2,2,0.5,0.5,true,true,850,350,850,350,0,0,0,true,true,true,-1.0
2,2,0.5,0.5,true,true,350,850,349,849,-1,-1,1,true,true,true,-1.0
2,2,0.5,0.5,true,true,350,250,349,249,-1,-1,1,true,true,true,-1.0
2,2,0.5,0.5,true,true,300,300,898,898,598,598,2,true,true,true,-1.0
2,2,0.5,0.5,true,true,200,300,797,897,597,597,3,true,true,true,-1.0
2,2,0.5,0.5,true,true,250,300,296,846,46,546,4,true,true,true,-1.0
2,2,0.5,0.5,true,true,200,350,799,949,599,599,1,true,true,true,-1.0
2,2,0.5,0.5,true,true,850,300,898,798,48,498,2,true,true,true,-1.0
2,2,0.5,0.5,true,true,300,300,349,799,49,499,1,true,true,true,-1.0
2,2,0.5,0.5,true,true,250,300,297,347,47,47,3,true,true,true,-1.0
2,2,0.5,0.5,true,true,250,850,249,849,-1,-1,1,true,true,true,-1.0
2,2,0.5,0.5,true,true,200,300,398,798,198,498,2,true,true,true,-1.0
2,2,0.5,0.5,true,true,200,300,200,300,0,0,0,true,true,true,-1.0
2,2,0.5,0.5,true,true,300,250,899,299,599,49,1,true,true,true,-1.0
2,2,0.5,0.5,true,true,300,350,300,350,0,0,0,true,true,true,-1.0
2,2,0.5,0.5,true,false,300,250,799,899,499,649,1,true,true,true,320.988
2,2,0.5,0.5,true,false,350,350,348,348,-2,-2,2,true,true,true,-1.0
2,2,0.5,0.5,true,false,900,350,900,350,0,0,0,true,true,true,-1.0
2,2,0.5,0.5,true,false,300,300,798,898,498,598,2,true,true,true,-1.0
2,2,0.5,0.5,true,false,300,300,298,298,-2,-2,2,true,true,true,-1.0
2,2,0.5,0.5,true,false,300,350,898,898,598,548,2,true,true,true,-1.0
2,2,0.5,0.5,true,false,300,300,298,298,-2,-2,2,true,true,true,-1.0
2,2,0.5,0.5,true,false,300,850,798,898,498,48,2,true,true,true,-1.0
2,2,0.5,0.5,true,false,250,250,250,250,0,0,0,true,true,true,-1.0
2,2,0.5,0.5,true,false,200,250,798,898,598,648,2,true,true,true,-1.0
2,2,0.5,0.5,true,false,300,850,299,849,-1,-1,1,true,true,true,-1.0
2,2,0.5,0.5,true,false,250,850,249,849,-1,-1,1,true,true,true,-1.0
2,2,0.5,0.5,true,false,300,300,300,300,0,0,0,true,true,true,-1.0
2,2,0.5,0.5,true,false,250,350,297,897,47,547,3,true,true,true,-1.0
2,2,0.5,0.5,true,false,850,250,850,250,0,0,0,true,true,true,-1.0
2,2,0.5,0.5,true,false,300,850,295,845,-5,-5,5,true,true,true,-1.0
2,2,0.5,0.5,true,false,300,200,799,249,499,49,1,true,true,true,-1.0
2,2,0.5,0.5,true,false,300,250,300,250,0,0,0,true,true,true,-1.0
2,2,0.5,0.5,true,false,300,350,299,349,-1,-1,1,true,true,true,-1.0
2,2,0.5,0.5,true,false,850,350,847,347,-3,-3,3,true,true,true,-1.0
2,2,0.5,0.5,false,true,350,850,349,849,-1,-1,1,true,true,true,187.196
2,2,0.5,0.5,false,true,300,300,349,799,49,499,1,true,true,true,-1.0
2,2,0.5,0.5,false,true,250,850,248,848,-2,-2,2,true,true,true,-1.0
2,2,0.5,0.5,false,true,250,850,798,898,548,48,2,true,true,true,-1.0
2,2,0.5,0.5,false,true,300,300,296,296,-4,-4,4,true,true,true,-1.0
2,2,0.5,0.5,false,true,250,200,898,798,648,598,2,true,true,true,-1.0
2,2,0.5,0.5,false,true,300,250,297,247,-3,-3,3,true,true,true,-1.0
2,2,0.5,0.5,false,true,300,250,297,247,-3,-3,3,true,true,true,-1.0
2,2,0.5,0.5,false,true,300,300,299,299,-1,-1,1,true,true,true,-1.0
2,2,0.5,0.5,false,true,200,250,199,249,-1,-1,1,true,true,true,-1.0
2,2,0.5,0.5,false,true,250,200,798,348,548,148,2,true,true,true,-1.0
2,2,0.5,0.5,false,true,300,250,798,348,498,98,2,true,true,true,-1.0
2,2,0.5,0.5,false,true,850,250,849,249,-1,-1,1,true,true,true,-1.0
2,2,0.5,0.5,false,true,900,250,900,250,0,0,0,true,true,true,-1.0
2,2,0.5,0.5,false,true,200,250,248,348,48,98,2,true,true,true,-1.0
2,2,0.5,0.5,false,true,250,200,799,249,549,49,1,true,true,true,-1.0
2,2,0.5,0.5,false,true,300,300,300,300,0,0,0,false,false,false,-1.0
2,2,0.5,0.5,false,true,900,250,900,250,0,0,0,false,false,false,-1.0
2,2,0.5,0.5,false,true,250,250,797,897,547,647,3,true,true,true,-1.0
2,2,0.5,0.5,false,true,300,300,348,798,48,498,2,true,true,true,-1.0
2,2,0.5,0.5,false,false,850,300,849,299,-1,-1,1,true,true,true,95.843
2,2,0.5,0.5,false,false,250,200,247,247,-3,47,3,true,true,true,-1.0
2,2,0.5,0.5,false,false,250,300,249,299,-1,-1,1,true,true,true,-1.0
2,2,0.5,0.5,false,false,350,350,349,349,-1,-1,1,true,true,true,-1.0
2,2,0.5,0.5,false,false,850,300,849,299,-1,-1,1,true,true,true,-1.0
2,2,0.5,0.5,false,false,300,300,298,298,-2,-2,2,true,true,true,-1.0
2,2,0.5,0.5,false,false,350,300,334,284,-16,-16,16,true,true,true,-1.0
2,2,0.5,0.5,false,false,850,250,849,249,-1,-1,1,true,true,true,-1.0
2,2,0.5,0.5,false,false,250,350,250,350,0,0,0,true,true,true,-1.0
2,2,0.5,0.5,false,false,850,300,848,298,-2,-2,2,true,true,true,-1.0
2,2,0.5,0.5,false,false,200,300,196,296,-4,-4,4,true,true,true,-1.0
2,2,0.5,0.5,false,false,200,900,199,899,-1,-1,1,true,true,true,-1.0
2,2,0.5,0.5,false,false,250,200,299,249,49,49,1,true,true,true,-1.0
2,2,0.5,0.5,false,false,900,350,899,349,-1,-1,1,true,true,true,-1.0
2,2,0.5,0.5,false,false,850,250,850,250,0,0,0,true,true,true,-1.0
2,2,0.5,0.5,false,false,250,300,797,897,547,597,3,true,true,true,-1.0
2,2,0.5,0.5,false,false,900,200,900,200,0,0,0,true,true,true,-1.0
2,2,0.5,0.5,false,false,850,300,849,299,-1,-1,1,true,true,true,-1.0
2,2,0.5,0.5,false,false,850,250,899,799,49,549,1,true,true,true,-1.0
2,2,0.5,0.5,false,false,250,250,348,798,98,548,2,true,true,true,-1.0
0,0,0.5,0.5,false,false,200,200,198,198,-2,-2,2,true,true,true,0.198
0,0,0.5,0.5,false,false,250,300,247,297,-3,-3,3,true,true,true,-1.0
0,0,0.5,0.5,false,false,850,200,847,197,-3,-3,3,true,true,true,-1.0
0,0,0.5,0.5,false,false,200,850,197,847,-3,-3,3,true,true,true,-1.0
0,0,0.5,0.5,false,false,200,850,796,896,596,46,4,true,true,true,-1.0
0,0,0.5,0.5,false,false,850,300,848,298,-2,-2,2,true,true,true,-1.0
0,0,0.5,0.5,false,false,850,250,846,246,-4,-4,4,true,true,true,-1.0
0,0,0.5,0.5,false,false,200,250,398,798,198,548,2,true,true,true,-1.0
0,0,0.5,0.5,false,false,300,250,297,247,-3,-3,3,true,true,true,-1.0
0,0,0.5,0.5,false,false,250,900,247,897,-3,-3,3,true,true,true,-1.0
0,0,0.5,0.5,false,false,200,250,246,796,46,546,4,true,true,true,-1.0
0,0,0.5,0.5,false,false,850,300,846,296,-4,-4,4,true,true,true,-1.0
0,0,0.5,0.5,false,false,200,850,197,847,-3,-3,3,true,true,true,-1.0
0,0,0.5,0.5,false,false,250,300,246,296,-4,-4,4,true,true,true,-1.0
0,0,0.5,0.5,false,false,300,250,297,247,-3,-3,3,true,true,true,-1.0
0,0,0.5,0.5,false,false,200,300,197,297,-3,-3,3,true,true,true,-1.0
0,0,0.5,0.5,false,false,250,250,248,248,-2,-2,2,true,true,true,-1.0
0,0,0.5,0.5,false,false,300,350,296,346,-4,-4,4,false,false,false,-1.0
0,0,0.5,0.5,false,false,850,200,846,196,-4,-4,4,false,false,false,-1.0
0,0,0.5,0.5,false,false,250,200,247,197,-3,-3,3,true,true,true,-1.0
0,1,0.5,0.5,false,false,850,300,848,298,-2,-2,2,true,true,true,0.297
0,1,0.5,0.5,false,false,250,300,298,798,48,498,2,true,true,true,-1.0
0,1,0.5,0.5,false,false,250,300,246,296,-4,-4,4,true,true,true,-1.0
0,1,0.5,0.5,false,false,250,300,899,849,649,549,1,true,true,true,-1.0
0,1,0.5,0.5,false,false,300,300,796,346,496,46,4,true,true,true,-1.0
0,1,0.5,0.5,false,false,300,850,796,896,496,46,4,true,true,true,-1.0
0,1,0.5,0.5,false,false,300,200,296,196,-4,-4,4,false,false,false,-1.0
0,1,0.5,0.5,false,false,250,350,246,346,-4,-4,4,true,true,true,-1.0
0,1,0.5,0.5,false,false,200,350,296,346,96,-4,4,true,true,true,-1.0
0,1,0.5,0.5,false,false,300,300,296,296,-4,-4,4,true,true,true,-1.0
0,1,0.5,0.5,false,false,850,200,848,198,-2,-2,2,true,true,true,-1.0
0,1,0.5,0.5,false,false,900,300,899,299,-1,-1,1,true,true,true,-1.0
0,1,0.5,0.5,false,false,300,850,799,899,499,49,1,true,true,true,-1.0
0,1,0.5,0.5,false,false,850,250,848,248,-2,-2,2,true,true,true,-1.0
0,1,0.5,0.5,false,false,250,250,246,246,-4,-4,4,true,true,true,-1.0
0,1,0.5,0.5,false,false,200,300,298,798,98,498,2,true,true,true,-1.0
0,1,0.5,0.5,false,false,300,300,348,798,48,498,2,true,true,true,-1.0
0,1,0.5,0.5,false,false,300,200,799,249,499,49,1,true,true,true,-1.0
0,1,0.5,0.5,false,false,250,250,246,246,-4,-4,4,true,true,true,-1.0
0,1,0.5,0.5,false,false,250,850,248,848,-2,-2,2,true,true,true,-1.0
0,2,0.5,0.5,false,true,300,850,299,849,-1,-1,1,true,true,true,410.773
0,2,0.5,0.5,false,true,250,300,246,296,-4,-4,4,false,false,false,-1.0
0,2,0.5,0.5,false,true,250,250,298,798,48,548,2,true,false,true,-1.0
0,2,0.5,0.5,false,true,250,300,849,849,599,549,1,true,true,true,-1.0
0,2,0.5,0.5,false,true,300,250,296,246,-4,-4,4,true,true,true,-1.0
0,2,0.5,0.5,false,true,300,850,296,846,-4,-4,4,true,true,true,-1.0
0,2,0.5,0.5,false,true,300,200,298,198,-2,-2,2,true,true,true,-1.0
0,2,0.5,0.5,false,true,850,250,846,246,-4,-4,4,true,true,true,-1.0
0,2,0.5,0.5,false,true,350,350,348,348,-2,-2,2,true,true,true,-1.0
0,2,0.5,0.5,false,true,850,850,846,846,-4,-4,4,true,true,true,-1.0
0,2,0.5,0.5,false,true,350,250,349,249,-1,-1,1,true,true,true,-1.0
0,2,0.5,0.5,false,true,250,200,348,798,98,598,2,true,true,true,-1.0
0,2,0.5,0.5,false,true,250,250,799,299,549,49,1,true,true,true,-1.0
0,2,0.5,0.5,false,true,300,250,898,898,598,648,2,true,true,true,-1.0
0,2,0.5,0.5,false,true,250,300,249,299,-1,-1,1,true,true,true,-1.0
0,2,0.5,0.5,false,true,850,850,849,849,-1,-1,1,true,true,true,-1.0
0,2,0.5,0.5,false,true,250,350,246,346,-4,-4,4,true,true,true,-1.0
0,2,0.5,0.5,false,true,200,250,199,249,-1,-1,1,true,true,true,-1.0
0,2,0.5,0.5,false,true,300,300,799,899,499,599,1,true,true,true,-1.0
0,2,0.5,0.5,false,true,300,850,297,847,-3,-3,3,true,true,true,-1.0
0,2,0.5,0.5,false,false,200,250,248,298,48,48,2,true,true,true,67.612
0,2,0.5,0.5,false,false,850,300,846,296,-4,-4,4,true,true,true,-1.0
0,2,0.5,0.5,false,false,300,200,898,848,598,648,2,true,true,true,-1.0
0,2,0.5,0.5,false,false,200,300,248,348,48,48,2,true,true,true,-1.0
0,2,0.5,0.5,false,false,250,200,249,199,-1,-1,1,true,true,true,-1.0
0,2,0.5,0.5,false,false,850,300,846,296,-4,-4,4,true,true,true,-1.0
0,2,0.5,0.5,false,false,300,350,296,346,-4,-4,4,true,true,true,-1.0
0,2,0.5,0.5,false,false,300,900,797,947,497,47,3,true,true,true,-1.0
0,2,0.5,0.5,false,false,200,250,248,798,48,548,2,true,true,true,-1.0
0,2,0.5,0.5,false,false,300,350,296,346,-4,-4,4,true,true,true,-1.0
0,2,0.5,0.5,false,false,300,900,296,896,-4,-4,4,true,true,true,-1.0
0,2,0.5,0.5,false,false,250,300,246,296,-4,-4,4,true,true,true,-1.0
0,2,0.5,0.5,false,false,200,200,248,298,48,98,2,true,true,true,-1.0
0,2,0.5,0.5,false,false,350,250,398,798,48,548,2,true,true,true,-1.0
0,2,0.5,0.5,false,false,250,250,298,798,48,548,2,true,false,true,-1.0
0,2,0.5,0.5,false,false,850,200,849,199,-1,-1,1,true,true,true,-1.0
0,2,0.5,0.5,false,false,850,900,849,899,-1,-1,1,true,true,true,-1.0
0,2,0.5,0.5,false,false,200,200,196,196,-4,-4,4,true,true,true,-1.0
0,2,0.5,0.5,false,false,200,200,248,298,48,98,2,true,false,true,-1.0
0,2,0.5,0.5,false,false,300,350,296,346,-4,-4,4,true,true,true,-1.0
1,0,0.5,0.5,false,false,200,300,197,297,-3,-3,3,true,true,true,0.278
1,0,0.5,0.5,false,false,200,850,249,899,49,49,1,true,true,true,-1.0
1,0,0.5,0.5,false,false,200,300,197,297,-3,-3,3,false,false,false,-1.0
1,0,0.5,0.5,false,false,250,300,250,300,0,0,0,false,false,false,-1.0
1,0,0.5,0.5,false,false,250,250,247,247,-3,-3,3,true,true,true,-1.0
1,0,0.5,0.5,false,false,250,200,247,197,-3,-3,3,true,true,true,-1.0
1,0,0.5,0.5,false,false,350,350,347,347,-3,-3,3,true,true,true,-1.0
1,0,0.5,0.5,false,false,250,300,897,347,647,47,3,true,true,true,-1.0
1,0,0.5,0.5,false,false,300,300,897,347,597,47,3,true,true,true,-1.0
1,0,0.5,0.5,false,false,200,200,200,200,0,0,0,true,true,true,-1.0
1,0,0.5,0.5,false,false,350,250,345,245,-5,-5,5,true,true,true,-1.0
1,0,0.5,0.5,false,false,200,300,297,347,97,47,3,true,true,true,-1.0
1,0,0.5,0.5,false,false,350,300,345,295,-5,-5,5,true,true,true,-1.0
1,0,0.5,0.5,false,false,200,850,197,847,-3,-3,3,true,true,true,-1.0
1,0,0.5,0.5,false,false,300,850,297,847,-3,-3,3,true,true,true,-1.0
1,0,0.5,0.5,false,false,300,900,799,949,499,49,1,true,true,true,-1.0
1,0,0.5,0.5,false,false,250,200,298,798,48,598,2,true,true,true,-1.0
1,0,0.5,0.5,false,false,250,850,247,847,-3,-3,3,true,true,true,-1.0
1,0,0.5,0.5,false,false,250,300,299,799,49,499,1,true,true,true,-1.0
1,0,0.5,0.5,false,false,300,300,349,799,49,499,1,true,true,true,-1.0
1,1,0.5,0.5,false,false,300,200,300,200,0,0,0,false,false,false,0.916
1,1,0.5,0.5,false,false,250,350,200,300,-50,-50,50,true,true,true,-1.0
1,1,0.5,0.5,false,false,200,300,197,297,-3,-3,3,true,true,true,-1.0
1,1,0.5,0.5,false,false,250,200,200,150,-50,-50,50,false,false,false,-1.0
1,1,0.5,0.5,false,false,300,250,348,798,48,548,2,true,true,true,-1.0
1,1,0.5,0.5,false,false,900,900,900,900,0,0,0,true,true,true,-1.0
1,1,0.5,0.5,false,false,300,300,250,250,-50,-50,50,false,false,false,-1.0
1,1,0.5,0.5,false,false,300,300,300,300,0,0,0,true,true,true,-1.0
1,1,0.5,0.5,false,false,350,350,350,350,0,0,0,true,true,true,-1.0
1,1,0.5,0.5,false,false,300,300,799,899,499,599,1,true,true,true,-1.0
1,1,0.5,0.5,false,false,250,250,345,295,95,45,5,true,true,true,-1.0
1,1,0.5,0.5,false,false,250,250,241,241,-9,-9,9,true,true,true,-1.0
1,1,0.5,0.5,false,false,300,200,300,200,0,0,0,true,true,true,-1.0
1,1,0.5,0.5,false,false,200,250,150,200,-50,-50,50,true,true,true,-1.0
1,1,0.5,0.5,false,false,250,250,797,297,547,47,3,true,true,true,-1.0
1,1,0.5,0.5,false,false,850,300,850,300,0,0,0,true,true,true,-1.0
1,1,0.5,0.5,false,false,850,250,850,250,0,0,0,true,true,true,-1.0
1,1,0.5,0.5,false,false,850,300,850,300,0,0,0,true,true,true,-1.0
1,1,0.5,0.5,false,false,300,300,250,250,-50,-50,50,true,true,true,-1.0
1,1,0.5,0.5,false,false,300,250,250,200,-50,-50,50,false,false,false,-1.0
1,2,0.5,0.5,false,true,300,850,298,848,-2,-2,2,true,true,true,705.149
1,2,0.5,0.5,false,true,250,250,248,248,-2,-2,2,true,true,true,-1.0
1,2,0.5,0.5,false,true,200,250,797,897,597,647,3,true,true,true,-1.0
1,2,0.5,0.5,false,true,850,300,848,298,-2,-2,2,true,true,true,-1.0
1,2,0.5,0.5,false,true,850,250,850,250,0,0,0,true,true,true,-1.0
1,2,0.5,0.5,false,true,250,200,250,200,0,0,0,true,true,true,-1.0
1,2,0.5,0.5,false,true,350,900,348,898,-2,-2,2,true,true,true,-1.0
1,2,0.5,0.5,false,true,250,200,799,899,549,699,1,true,true,true,-1.0
1,2,0.5,0.5,false,true,300,250,798,298,498,48,2,true,true,true,-1.0
1,2,0.5,0.5,false,true,200,200,198,198,-2,-2,2,true,true,true,-1.0
1,2,0.5,0.5,false,true,250,250,847,847,597,597,3,true,true,true,-1.0
1,2,0.5,0.5,false,true,200,250,298,298,98,48,2,true,true,true,-1.0
1,2,0.5,0.5,false,true,300,900,298,898,-2,-2,2,true,true,true,-1.0
1,2,0.5,0.5,false,true,300,300,775,325,475,25,25,true,true,true,-1.0
1,2,0.5,0.5,false,true,850,250,849,249,-1,-1,1,true,true,true,-1.0
1,2,0.5,0.5,false,true,200,300,198,298,-2,-2,2,true,true,true,-1.0
1,2,0.5,0.5,false,true,200,350,197,347,-3,-3,3,true,true,true,-1.0
1,2,0.5,0.5,false,true,900,350,898,348,-2,-2,2,true,true,true,-1.0
1,2,0.5,0.5,false,true,200,250,247,297,47,47,3,true,true,true,-1.0
1,2,0.5,0.5,false,true,250,300,799,899,549,599,1,true,true,true,-1.0
1,2,0.5,0.5,false,false,250,200,250,200,0,0,0,false,false,false,88.601
1,2,0.5,0.5,false,false,300,300,298,298,-2,-2,2,true,true,true,-1.0
1,2,0.5,0.5,false,false,850,300,899,799,49,499,1,true,true,true,-1.0
1,2,0.5,0.5,false,false,250,850,248,848,-2,-2,2,true,true,true,-1.0
1,2,0.5,0.5,false,false,250,900,248,898,-2,-2,2,true,true,true,-1.0
1,2,0.5,0.5,false,false,300,200,835,285,535,85,15,true,true,true,-1.0
1,2,0.5,0.5,false,false,300,850,298,848,-2,-2,2,true,true,true,-1.0
1,2,0.5,0.5,false,false,350,250,350,250,0,0,0,true,true,true,-1.0
1,2,0.5,0.5,false,false,300,350,755,355,455,5,45,true,true,true,-1.0
1,2,0.5,0.5,false,false,200,250,198,248,-2,-2,2,true,true,true,-1.0
1,2,0.5,0.5,false,false,250,200,200,150,-50,-50,50,false,false,false,-1.0
1,2,0.5,0.5,false,false,250,850,248,848,-2,-2,2,true,true,true,-1.0
1,2,0.5,0.5,false,false,250,250,867,267,617,17,33,true,true,true,-1.0
1,2,0.5,0.5,false,false,250,250,295,295,45,45,5,true,true,true,-1.0
1,2,0.5,0.5,false,false,250,300,250,300,0,0,0,true,true,true,-1.0
1,2,0.5,0.5,false,false,300,300,298,298,-2,-2,2,true,true,true,-1.0
1,2,0.5,0.5,false,false,300,250,898,798,598,548,2,true,true,true,-1.0
1,2,0.5,0.5,false,false,250,900,249,899,-1,-1,1,true,true,true,-1.0
1,2,0.5,0.5,false,false,350,200,300,150,-50,-50,50,false,false,false,-1.0
1,2,0.5,0.5,false,false,300,200,298,198,-2,-2,2,true,true,true,-1.0
2,0,0.5,0.5,true,false,300,250,300,250,0,0,0,true,true,true,609.006
2,0,0.5,0.5,true,false,900,850,897,847,-3,-3,3,true,true,true,-1.0
2,0,0.5,0.5,true,false,250,300,299,799,49,499,1,true,true,true,-1.0
2,0,0.5,0.5,true,false,300,200,847,297,547,97,3,true,true,true,-1.0
2,0,0.5,0.5,true,false,850,200,897,247,47,47,3,true,true,true,-1.0
2,0,0.5,0.5,true,false,300,250,849,299,549,49,1,true,true,true,-1.0
2,0,0.5,0.5,true,false,850,250,850,250,0,0,0,true,true,true,-1.0
2,0,0.5,0.5,true,false,250,200,297,247,47,47,3,true,true,true,-1.0
2,0,0.5,0.5,true,false,300,300,300,300,0,0,0,true,true,true,-1.0
2,0,0.5,0.5,true,false,250,850,247,847,-3,-3,3,true,true,true,-1.0
2,0,0.5,0.5,true,false,250,900,245,895,-5,-5,5,true,true,true,-1.0
2,0,0.5,0.5,true,false,850,300,847,297,-3,-3,3,true,true,true,-1.0
2,0,0.5,0.5,true,false,850,300,850,300,0,0,0,true,true,true,-1.0
2,0,0.5,0.5,true,false,350,200,350,200,0,0,0,true,true,true,-1.0
2,0,0.5,0.5,true,false,300,350,295,345,-5,-5,5,false,false,false,-1.0
2,0,0.5,0.5,true,false,250,350,798,948,548,598,2,true,true,true,-1.0
2,0,0.5,0.5,true,false,250,200,899,849,649,649,1,true,true,true,-1.0
2,0,0.5,0.5,true,false,850,300,848,298,-2,-2,2,true,true,true,-1.0
2,0,0.5,0.5,true,false,250,300,247,297,-3,-3,3,true,true,true,-1.0
2,0,0.5,0.5,true,false,200,250,249,799,49,549,1,true,true,true,-1.0
2,0,0.5,0.5,false,false,850,250,899,799,49,549,1,true,true,true,95.995
2,0,0.5,0.5,false,false,250,250,245,245,-5,-5,5,false,false,false,-1.0
2,0,0.5,0.5,false,false,850,300,847,297,-3,-3,3,true,true,true,-1.0
2,0,0.5,0.5,false,false,250,300,296,796,46,496,4,true,true,true,-1.0
2,0,0.5,0.5,false,false,850,850,850,850,0,0,0,true,true,true,-1.0
2,0,0.5,0.5,false,false,300,300,300,300,0,0,0,true,true,true,-1.0
2,0,0.5,0.5,false,false,200,250,197,247,-3,-3,3,true,true,true,-1.0
2,0,0.5,0.5,false,false,300,300,297,297,-3,-3,3,true,true,true,-1.0
2,0,0.5,0.5,false,false,200,250,197,247,-3,-3,3,true,true,true,-1.0
2,0,0.5,0.5,false,false,200,250,195,245,-5,-5,5,false,false,false,-1.0
2,0,0.5,0.5,false,false,300,250,797,297,497,47,3,true,true,true,-1.0
2,0,0.5,0.5,false,false,250,850,247,847,-3,-3,3,true,true,true,-1.0
2,0,0.5,0.5,false,false,850,300,845,295,-5,-5,5,true,true,true,-1.0
2,0,0.5,0.5,false,false,300,850,297,847,-3,-3,3,true,true,true,-1.0
2,0,0.5,0.5,false,false,300,200,300,200,0,0,0,true,true,true,-1.0
2,0,0.5,0.5,false,false,250,300,247,297,-3,-3,3,true,true,true,-1.0
2,0,0.5,0.5,false,false,300,300,295,295,-5,-5,5,true,true,true,-1.0
2,0,0.5,0.5,false,false,250,250,299,799,49,549,1,true,true,true,-1.0
2,0,0.5,0.5,false,false,250,300,346,796,96,496,4,true,true,true,-1.0
2,0,0.5,0.5,false,false,250,850,247,847,-3,-3,3,true,true,true,-1.0
2,1,0.5,0.5,true,false,850,850,849,849,-1,-1,1,true,true,true,660.236
2,1,0.5,0.5,true,false,200,250,197,247,-3,-3,3,true,true,true,-1.0
2,1,0.5,0.5,true,false,850,200,847,197,-3,-3,3,true,true,true,-1.0
2,1,0.5,0.5,true,false,250,200,250,200,0,0,0,true,true,true,-1.0
2,1,0.5,0.5,true,false,300,200,898,798,598,598,2,true,true,true,-1.0
2,1,0.5,0.5,true,false,250,250,245,245,-5,-5,5,true,true,true,-1.0
2,1,0.5,0.5,true,false,850,250,898,798,48,548,2,true,true,true,-1.0
2,1,0.5,0.5,true,false,300,300,295,295,-5,-5,5,true,true,true,-1.0
2,1,0.5,0.5,true,false,200,300,298,848,98,548,2,true,true,true,-1.0
2,1,0.5,0.5,true,false,850,250,849,249,-1,-1,1,true,true,true,-1.0
2,1,0.5,0.5,true,false,300,300,297,297,-3,-3,3,true,true,true,-1.0
2,1,0.5,0.5,true,false,200,250,150,200,-50,-50,50,false,false,false,-1.0
2,1,0.5,0.5,true,false,250,300,250,300,0,0,0,true,true,true,-1.0
2,1,0.5,0.5,true,false,300,250,847,297,547,47,3,true,false,true,-1.0
2,1,0.5,0.5,true,false,200,850,197,847,-3,-3,3,true,true,true,-1.0
2,1,0.5,0.5,true,false,250,350,249,349,-1,-1,1,false,false,false,-1.0
2,1,0.5,0.5,true,false,900,300,897,297,-3,-3,3,true,true,true,-1.0
2,1,0.5,0.5,true,false,300,200,897,297,597,97,3,true,true,true,-1.0
2,1,0.5,0.5,true,false,250,300,247,297,-3,-3,3,true,true,true,-1.0
2,1,0.5,0.5,true,false,250,300,247,297,-3,-3,3,true,true,true,-1.0
2,1,0.5,0.5,false,false,250,200,250,200,0,0,0,true,true,true,127.785
2,1,0.5,0.5,false,false,850,250,847,247,-3,-3,3,true,true,true,-1.0
2,1,0.5,0.5,false,false,850,300,899,799,49,499,1,true,true,true,-1.0
2,1,0.5,0.5,false,false,350,850,347,847,-3,-3,3,true,true,true,-1.0
2,1,0.5,0.5,false,false,850,300,849,299,-1,-1,1,true,true,true,-1.0
2,1,0.5,0.5,false,false,300,300,297,297,-3,-3,3,true,true,true,-1.0
2,1,0.5,0.5,false,false,300,900,297,897,-3,-3,3,true,true,true,-1.0
2,1,0.5,0.5,false,false,200,200,249,299,49,99,1,true,true,true,-1.0
2,1,0.5,0.5,false,false,200,250,197,247,-3,-3,3,true,true,true,-1.0
2,1,0.5,0.5,false,false,350,200,898,298,548,98,2,true,true,true,-1.0
2,1,0.5,0.5,false,false,350,250,898,848,548,598,2,true,true,true,-1.0
2,1,0.5,0.5,false,false,200,300,298,798,98,498,2,true,true,true,-1.0
2,1,0.5,0.5,false,false,250,250,799,299,549,49,1,true,true,true,-1.0
2,1,0.5,0.5,false,false,300,300,297,297,-3,-3,3,true,true,true,-1.0
2,1,0.5,0.5,false,false,900,200,949,249,49,49,1,true,true,true,-1.0
2,1,0.5,0.5,false,false,850,250,847,247,-3,-3,3,true,true,true,-1.0
2,1,0.5,0.5,false,false,200,850,200,850,0,0,0,true,true,true,-1.0
2,1,0.5,0.5,false,false,850,300,898,798,48,498,2,true,true,true,-1.0
2,1,0.5,0.5,false,false,850,200,850,200,0,0,0,true,true,true,-1.0
2,1,0.5,0.5,false,false,250,850,268,868,18,18,32,true,true,true,-1.0
2,2,0.5,0.5,true,true,850,250,899,799,49,549,1,true,true,true,537.052
2,2,0.5,0.5,true,true,300,300,297,297,-3,-3,3,true,true,true,-1.0
2,2,0.5,0.5,true,true,200,250,299,299,99,49,1,true,false,true,-1.0
2,2,0.5,0.5,true,true,250,250,797,347,547,97,3,true,true,true,-1.0
2,2,0.5,0.5,true,true,350,300,350,300,0,0,0,true,true,true,-1.0
2,2,0.5,0.5,true,true,250,250,849,849,599,599,1,true,true,true,-1.0
2,2,0.5,0.5,true,true,200,300,199,299,-1,-1,1,true,true,true,-1.0
2,2,0.5,0.5,true,true,300,300,300,300,0,0,0,true,true,true,-1.0
2,2,0.5,0.5,true,true,200,250,199,249,-1,-1,1,true,true,true,-1.0
2,2,0.5,0.5,true,true,350,350,350,350,0,0,0,true,true,true,-1.0
2,2,0.5,0.5,true,true,300,250,348,298,48,48,2,true,true,true,-1.0
2,2,0.5,0.5,true,true,850,350,849,349,-1,-1,1,true,true,true,-1.0
2,2,0.5,0.5,true,true,250,900,248,898,-2,-2,2,true,true,true,-1.0
2,2,0.5,0.5,true,true,200,900,247,947,47,47,3,true,true,true,-1.0
2,2,0.5,0.5,true,true,300,850,298,848,-2,-2,2,true,true,true,-1.0
2,2,0.5,0.5,true,true,300,200,347,247,47,47,3,true,true,true,-1.0
2,2,0.5,0.5,true,true,850,300,898,798,48,498,2,true,true,true,-1.0
2,2,0.5,0.5,true,true,850,250,849,249,-1,-1,1,true,true,true,-1.0
2,2,0.5,0.5,true,true,200,250,248,898,48,648,2,true,true,true,-1.0
2,2,0.5,0.5,true,true,850,850,849,849,-1,-1,1,true,true,true,-1.0
2,2,0.5,0.5,true,false,200,300,248,348,48,48,2,true,true,true,477.932
2,2,0.5,0.5,true,false,200,250,199,249,-1,-1,1,true,true,true,-1.0
2,2,0.5,0.5,true,false,850,300,899,799,49,499,1,true,true,true,-1.0
2,2,0.5,0.5,true,false,850,300,849,299,-1,-1,1,true,true,true,-1.0
2,2,0.5,0.5,true,false,850,200,850,200,0,0,0,true,true,true,-1.0
2,2,0.5,0.5,true,false,200,200,198,198,-2,-2,2,true,true,true,-1.0
2,2,0.5,0.5,true,false,850,200,899,249,49,49,1,true,false,true,-1.0
2,2,0.5,0.5,true,false,300,250,797,297,497,47,3,true,true,true,-1.0
2,2,0.5,0.5,true,false,250,250,249,249,-1,-1,1,true,true,true,-1.0
2,2,0.5,0.5,true,false,250,350,248,348,-2,-2,2,true,true,true,-1.0
2,2,0.5,0.5,true,false,250,850,248,848,-2,-2,2,true,true,true,-1.0
2,2,0.5,0.5,true,false,250,850,248,848,-2,-2,2,true,true,true,-1.0
2,2,0.5,0.5,true,false,300,300,797,347,497,47,3,true,true,true,-1.0
2,2,0.5,0.5,true,false,200,250,200,250,0,0,0,true,true,true,-1.0
2,2,0.5,0.5,true,false,300,250,799,299,499,49,1,true,true,true,-1.0
2,2,0.5,0.5,true,false,300,250,848,848,548,598,2,true,true,true,-1.0
2,2,0.5,0.5,true,false,300,250,300,250,0,0,0,true,true,true,-1.0
2,2,0.5,0.5,true,false,300,200,898,348,598,148,2,true,true,true,-1.0
2,2,0.5,0.5,true,false,850,200,898,248,48,48,2,true,true,true,-1.0
2,2,0.5,0.5,true,false,250,850,249,849,-1,-1,1,true,true,true,-1.0
2,2,0.5,0.5,false,true,250,250,250,250,0,0,0,true,true,true,283.504
2,2,0.5,0.5,false,true,850,300,849,299,-1,-1,1,true,true,true,-1.0
2,2,0.5,0.5,false,true,300,200,300,200,0,0,0,true,true,true,-1.0
2,2,0.5,0.5,false,true,850,850,849,849,-1,-1,1,true,true,true,-1.0
2,2,0.5,0.5,false,true,200,250,299,899,99,649,1,true,true,true,-1.0
2,2,0.5,0.5,false,true,850,300,848,298,-2,-2,2,true,true,true,-1.0
2,2,0.5,0.5,false,true,850,200,848,198,-2,-2,2,true,true,true,-1.0
2,2,0.5,0.5,false,true,300,300,798,348,498,48,2,true,true,true,-1.0
2,2,0.5,0.5,false,true,200,300,246,796,46,496,4,true,true,true,-1.0
2,2,0.5,0.5,false,true,300,850,299,849,-1,-1,1,true,true,true,-1.0
2,2,0.5,0.5,false,true,250,200,200,150,-50,-50,50,false,false,false,-1.0
2,2,0.5,0.5,false,true,300,300,300,300,0,0,0,true,true,true,-1.0
2,2,0.5,0.5,false,true,850,300,849,299,-1,-1,1,true,true,true,-1.0
2,2,0.5,0.5,false,true,200,300,249,799,49,499,1,true,true,true,-1.0
2,2,0.5,0.5,false,true,350,850,349,849,-1,-1,1,true,true,true,-1.0
2,2,0.5,0.5,false,true,200,250,248,798,48,548,2,true,true,true,-1.0
2,2,0.5,0.5,false,true,250,200,298,798,48,598,2,true,true,true,-1.0
2,2,0.5,0.5,false,true,350,200,399,249,49,49,1,true,true,true,-1.0
2,2,0.5,0.5,false,true,900,900,899,899,-1,-1,1,true,true,true,-1.0
2,2,0.5,0.5,false,true,200,850,199,849,-1,-1,1,true,true,true,-1.0
2,2,0.5,0.5,false,false,900,850,899,849,-1,-1,1,true,true,true,105.498
2,2,0.5,0.5,false,false,300,300,797,347,497,47,3,true,true,true,-1.0
2,2,0.5,0.5,false,false,300,850,299,849,-1,-1,1,true,true,true,-1.0
2,2,0.5,0.5,false,false,250,200,349,299,99,99,1,true,true,true,-1.0
2,2,0.5,0.5,false,false,200,300,200,300,0,0,0,true,true,true,-1.0
2,2,0.5,0.5,false,false,850,250,899,799,49,549,1,true,true,true,-1.0
2,2,0.5,0.5,false,false,250,350,249,349,-1,-1,1,true,true,true,-1.0
2,2,0.5,0.5,false,false,300,850,299,849,-1,-1,1,true,true,true,-1.0
2,2,0.5,0.5,false,false,850,300,849,299,-1,-1,1,true,true,true,-1.0
2,2,0.5,0.5,false,false,850,250,849,249,-1,-1,1,true,true,true,-1.0
2,2,0.5,0.5,false,false,300,200,300,200,0,0,0,true,true,true,-1.0
2,2,0.5,0.5,false,false,350,900,348,898,-2,-2,2,true,true,true,-1.0
2,2,0.5,0.5,false,false,200,200,299,799,99,599,1,true,true,true,-1.0
2,2,0.5,0.5,false,false,250,850,250,850,0,0,0,true,true,true,-1.0
2,2,0.5,0.5,false,false,200,850,199,849,-1,-1,1,true,true,true,-1.0
2,2,0.5,0.5,false,false,300,200,798,248,498,48,2,true,true,true,-1.0
2,2,0.5,0.5,false,false,300,850,298,848,-2,-2,2,true,true,true,-1.0
2,2,0.5,0.5,false,false,850,250,850,250,0,0,0,true,true,true,-1.0
2,2,0.5,0.5,false,false,200,200,200,200,0,0,0,true,true,true,-1.0
2,2,0.5,0.5,false,false,200,300,797,347,597,47,3,true,true,true,-1.0
0,0,0.5,0.5,false,false,250,250,797,297,547,47,3,true,true,true,0.176
0,0,0.5,0.5,false,false,200,250,197,247,-3,-3,3,true,true,true,-1.0
0,0,0.5,0.5,false,false,850,300,898,798,48,498,2,true,true,true,-1.0
0,0,0.5,0.5,false,false,250,900,247,897,-3,-3,3,true,true,true,-1.0
0,0,0.5,0.5,false,false,250,300,398,798,148,498,2,true,true,true,-1.0
0,0,0.5,0.5,false,false,350,250,348,248,-2,-2,2,true,true,true,-1.0
0,0,0.5,0.5,false,false,300,250,797,397,497,147,3,true,true,true,-1.0
0,0,0.5,0.5,false,false,900,200,896,196,-4,-4,4,true,true,true,-1.0
0,0,0.5,0.5,false,false,250,200,246,196,-4,-4,4,true,true,true,-1.0
0,0,0.5,0.5,false,false,350,850,347,847,-3,-3,3,true,true,true,-1.0
0,0,0.5,0.5,false,false,200,300,248,898,48,598,2,true,true,true,-1.0
0,0,0.5,0.5,false,false,300,200,297,197,-3,-3,3,true,true,true,-1.0
0,0,0.5,0.5,false,false,200,300,797,397,597,97,3,true,true,true,-1.0
0,0,0.5,0.5,false,false,900,250,948,798,48,548,2,true,true,true,-1.0
0,0,0.5,0.5,false,false,250,350,248,348,-2,-2,2,true,true,true,-1.0
0,0,0.5,0.5,false,false,200,300,197,297,-3,-3,3,true,true,true,-1.0
0,0,0.5,0.5,false,false,850,300,848,298,-2,-2,2,true,true,true,-1.0
0,0,0.5,0.5,false,false,250,350,247,347,-3,-3,3,true,true,true,-1.0
0,0,0.5,0.5,false,false,250,850,246,846,-4,-4,4,false,false,false,-1.0
0,0,0.5,0.5,false,false,250,850,246,846,-4,-4,4,false,false,false,-1.0
0,1,0.5,0.5,false,false,350,850,346,846,-4,-4,4,true,true,true,0.297
0,1,0.5,0.5,false,false,250,900,247,897,-3,-3,3,true,true,true,-1.0
0,1,0.5,0.5,false,false,850,200,846,196,-4,-4,4,true,true,true,-1.0
0,1,0.5,0.5,false,false,250,300,247,297,-3,-3,3,true,true,true,-1.0
0,1,0.5,0.5,false,false,200,200,199,199,-1,-1,1,true,true,true,-1.0
0,1,0.5,0.5,false,false,250,300,298,898,48,598,2,true,true,true,-1.0
0,1,0.5,0.5,false,false,250,250,246,246,-4,-4,4,true,true,true,-1.0
0,1,0.5,0.5,false,false,300,350,797,397,497,47,3,true,true,true,-1.0
0,1,0.5,0.5,false,false,250,350,298,898,48,548,2,true,true,true,-1.0
0,1,0.5,0.5,false,false,250,300,298,848,48,548,2,true,true,true,-1.0
0,1,0.5,0.5,false,false,250,250,298,798,48,548,2,true,true,true,-1.0
0,1,0.5,0.5,false,false,200,250,799,299,599,49,1,true,true,true,-1.0
0,1,0.5,0.5,false,false,850,850,846,846,-4,-4,4,true,true,true,-1.0
0,1,0.5,0.5,false,false,250,300,298,348,48,48,2,true,true,true,-1.0
0,1,0.5,0.5,false,false,850,300,846,296,-4,-4,4,true,true,true,-1.0
0,1,0.5,0.5,false,false,200,300,298,848,98,548,2,true,true,true,-1.0
0,1,0.5,0.5,false,false,300,300,297,297,-3,-3,3,true,true,true,-1.0
0,1,0.5,0.5,false,false,200,850,196,846,-4,-4,4,true,true,true,-1.0
0,1,0.5,0.5,false,false,200,350,248,898,48,548,2,true,true,true,-1.0
0,1,0.5,0.5,false,false,850,850,846,846,-4,-4,4,true,true,true,-1.0
0,2,0.5,0.5,false,true,200,200,196,196,-4,-4,4,true,true,true,351.773
0,2,0.5,0.5,false,true,250,900,799,949,549,49,1,true,true,true,-1.0
0,2,0.5,0.5,false,true,300,250,797,347,497,97,3,true,true,true,-1.0
0,2,0.5,0.5,false,true,850,900,849,899,-1,-1,1,true,true,true,-1.0
0,2,0.5,0.5,false,true,300,250,297,247,-3,-3,3,true,true,true,-1.0
0,2,0.5,0.5,false,true,300,300,799,349,499,49,1,true,true,true,-1.0
0,2,0.5,0.5,false,true,250,250,799,899,549,649,1,true,true,true,-1.0
0,2,0.5,0.5,false,true,250,850,247,847,-3,-3,3,true,true,true,-1.0
0,2,0.5,0.5,false,true,250,250,298,898,48,648,2,true,true,true,-1.0
0,2,0.5,0.5,false,true,200,250,197,247,-3,-3,3,true,true,true,-1.0
0,2,0.5,0.5,false,true,200,200,199,199,-1,-1,1,true,true,true,-1.0
0,2,0.5,0.5,false,true,300,300,898,798,598,498,2,true,true,true,-1.0
0,2,0.5,0.5,false,true,200,300,248,798,48,498,2,true,true,true,-1.0
0,2,0.5,0.5,false,true,850,300,896,796,46,496,4,true,true,true,-1.0
0,2,0.5,0.5,false,true,850,300,846,296,-4,-4,4,true,true,true,-1.0
0,2,0.5,0.5,false,true,200,250,799,349,599,99,1,true,true,true,-1.0
0,2,0.5,0.5,false,true,850,850,846,846,-4,-4,4,true,true,true,-1.0
0,2,0.5,0.5,false,true,250,850,247,847,-3,-3,3,true,true,true,-1.0
0,2,0.5,0.5,false,true,300,850,296,846,-4,-4,4,true,true,true,-1.0
0,2,0.5,0.5,false,true,300,200,296,196,-4,-4,4,true,true,true,-1.0
0,2,0.5,0.5,false,false,350,200,396,796,46,596,4,true,true,true,71.512
0,2,0.5,0.5,false,false,850,250,846,246,-4,-4,4,true,true,true,-1.0
0,2,0.5,0.5,false,false,300,300,296,296,-4,-4,4,true,true,true,-1.0
0,2,0.5,0.5,false,false,250,300,799,949,549,649,1,true,true,true,-1.0
0,2,0.5,0.5,false,false,300,300,296,296,-4,-4,4,true,true,true,-1.0
0,2,0.5,0.5,false,false,250,300,898,798,648,498,2,true,true,true,-1.0
0,2,0.5,0.5,false,false,250,250,246,246,-4,-4,4,true,true,true,-1.0
0,2,0.5,0.5,false,false,900,250,899,249,-1,-1,1,true,true,true,-1.0
0,2,0.5,0.5,false,false,300,250,296,246,-4,-4,4,false,false,false,-1.0
0,2,0.5,0.5,false,false,300,300,299,299,-1,-1,1,true,true,true,-1.0
0,2,0.5,0.5,false,false,300,300,296,296,-4,-4,4,true,true,true,-1.0
0,2,0.5,0.5,false,false,300,850,297,847,-3,-3,3,true,true,true,-1.0
0,2,0.5,0.5,false,false,350,250,346,246,-4,-4,4,true,true,true,-1.0
0,2,0.5,0.5,false,false,850,850,846,846,-4,-4,4,true,true,true,-1.0
0,2,0.5,0.5,false,false,250,850,247,847,-3,-3,3,true,true,true,-1.0
0,2,0.5,0.5,false,false,850,300,846,296,-4,-4,4,true,true,true,-1.0
0,2,0.5,0.5,false,false,200,850,199,849,-1,-1,1,true,true,true,-1.0
0,2,0.5,0.5,false,false,250,300,246,296,-4,-4,4,true,true,true,-1.0
0,2,0.5,0.5,false,false,300,300,297,297,-3,-3,3,true,true,true,-1.0
0,2,0.5,0.5,false,false,300,350,297,347,-3,-3,3,true,true,true,-1.0
1,0,0.5,0.5,false,false,300,850,799,899,499,49,1,true,true,true,0.301
1,0,0.5,0.5,false,false,850,250,895,295,45,45,5,true,true,true,-1.0
1,0,0.5,0.5,false,false,850,300,899,799,49,499,1,true,true,true,-1.0
1,0,0.5,0.5,false,false,850,250,850,250,0,0,0,true,true,true,-1.0
1,0,0.5,0.5,false,false,200,850,197,847,-3,-3,3,true,true,true,-1.0
1,0,0.5,0.5,false,false,350,300,949,799,599,499,1,true,true,true,-1.0
1,0,0.5,0.5,false,false,350,850,350,850,0,0,0,true,true,true,-1.0
1,0,0.5,0.5,false,false,350,250,347,247,-3,-3,3,true,true,true,-1.0
1,0,0.5,0.5,false,false,850,300,845,295,-5,-5,5,true,true,true,-1.0
1,0,0.5,0.5,false,false,200,300,249,799,49,499,1,true,true,true,-1.0
1,0,0.5,0.5,false,false,250,300,299,799,49,499,1,true,true,true,-1.0
1,0,0.5,0.5,false,false,850,200,845,195,-5,-5,5,true,true,true,-1.0
1,0,0.5,0.5,false,false,250,250,899,849,649,599,1,true,true,true,-1.0
1,0,0.5,0.5,false,false,850,850,850,850,0,0,0,true,true,true,-1.0
1,0,0.5,0.5,false,false,300,300,300,300,0,0,0,true,true,true,-1.0
1,0,0.5,0.5,false,false,250,250,250,250,0,0,0,true,true,true,-1.0
1,0,0.5,0.5,false,false,300,200,300,200,0,0,0,true,true,true,-1.0
1,0,0.5,0.5,false,false,250,250,847,297,597,47,3,true,true,true,-1.0
1,0,0.5,0.5,false,false,850,250,899,799,49,549,1,true,true,true,-1.0
1,0,0.5,0.5,false,false,250,300,898,798,648,498,2,true,true,true,-1.0
1,1,0.5,0.5,false,false,250,200,200,150,-50,-50,50,true,true,true,1.306
1,1,0.5,0.5,false,false,300,350,297,347,-3,-3,3,true,true,true,-1.0
1,1,0.5,0.5,false,false,200,300,248,898,48,598,2,true,true,true,-1.0
1,1,0.5,0.5,false,false,850,350,800,300,-50,-50,50,true,true,true,-1.0
1,1,0.5,0.5,false,false,250,200,399,799,149,599,1,true,true,true,-1.0
1,1,0.5,0.5,false,false,850,350,800,300,-50,-50,50,true,true,true,-1.0
1,1,0.5,0.5,false,false,300,300,797,347,497,47,3,true,true,true,-1.0
1,1,0.5,0.5,false,false,200,200,150,150,-50,-50,50,true,true,true,-1.0
1,1,0.5,0.5,false,false,250,250,298,798,48,548,2,true,true,true,-1.0
1,1,0.5,0.5,false,false,850,250,800,200,-50,-50,50,true,true,true,-1.0
1,1,0.5,0.5,false,false,300,200,300,200,0,0,0,true,true,true,-1.0
1,1,0.5,0.5,false,false,200,900,197,897,-3,-3,3,true,true,true,-1.0
1,1,0.5,0.5,false,false,200,200,150,150,-50,-50,50,false,false,false,-1.0
1,1,0.5,0.5,false,false,250,350,249,349,-1,-1,1,true,true,true,-1.0
1,1,0.5,0.5,false,false,300,250,250,200,-50,-50,50,true,true,true,-1.0
1,1,0.5,0.5,false,false,350,350,350,350,0,0,0,true,true,true,-1.0
1,1,0.5,0.5,false,false,300,250,300,250,0,0,0,false,false,false,-1.0
1,1,0.5,0.5,false,false,350,850,350,850,0,0,0,true,true,true,-1.0
1,1,0.5,0.5,false,false,350,250,350,250,0,0,0,true,true,true,-1.0
1,1,0.5,0.5,false,false,350,250,949,799,599,549,1,true,true,true,-1.0
1,2,0.5,0.5,false,true,900,250,949,799,49,549,1,true,true,true,804.111
1,2,0.5,0.5,false,true,200,250,248,398,48,148,2,true,true,true,-1.0
1,2,0.5,0.5,false,true,250,300,246,296,-4,-4,4,true,true,true,-1.0
1,2,0.5,0.5,false,true,300,300,798,798,498,498,2,true,true,true,-1.0
1,2,0.5,0.5,false,true,300,200,848,898,548,698,2,true,true,true,-1.0
1,2,0.5,0.5,false,true,350,250,398,798,48,548,2,true,true,true,-1.0
1,2,0.5,0.5,false,true,250,850,796,896,546,46,4,true,true,true,-1.0
1,2,0.5,0.5,false,true,200,850,198,848,-2,-2,2,true,true,true,-1.0
1,2,0.5,0.5,false,true,250,200,250,200,0,0,0,false,false,false,-1.0
1,2,0.5,0.5,false,true,300,200,300,200,0,0,0,true,true,true,-1.0
1,2,0.5,0.5,false,true,300,300,349,799,49,499,1,true,true,true,-1.0
1,2,0.5,0.5,false,true,200,300,198,298,-2,-2,2,true,true,true,-1.0
1,2,0.5,0.5,false,true,250,850,248,848,-2,-2,2,true,true,true,-1.0
1,2,0.5,0.5,false,true,200,250,150,200,-50,-50,50,false,false,false,-1.0
1,2,0.5,0.5,false,true,300,850,300,850,0,0,0,true,true,true,-1.0
1,2,0.5,0.5,false,true,250,250,250,250,0,0,0,true,true,true,-1.0
1,2,0.5,0.5,false,true,900,850,898,848,-2,-2,2,true,true,true,-1.0
1,2,0.5,0.5,false,true,300,300,300,300,0,0,0,true,true,true,-1.0
1,2,0.5,0.5,false,true,350,200,350,200,0,0,0,true,true,true,-1.0
1,2,0.5,0.5,false,true,200,300,200,300,0,0,0,true,true,true,-1.0
1,2,0.5,0.5,false,false,300,300,298,298,-2,-2,2,true,true,true,122.876
1,2,0.5,0.5,false,false,300,850,298,848,-2,-2,2,true,true,true,-1.0
1,2,0.5,0.5,false,false,850,250,850,250,0,0,0,true,true,true,-1.0
1,2,0.5,0.5,false,false,250,250,248,248,-2,-2,2,true,true,true,-1.0
1,2,0.5,0.5,false,false,350,250,949,799,599,549,1,true,true,true,-1.0
1,2,0.5,0.5,false,false,300,200,300,200,0,0,0,true,true,true,-1.0
1,2,0.5,0.5,false,false,250,200,297,247,47,47,3,true,true,true,-1.0
1,2,0.5,0.5,false,false,250,250,250,250,0,0,0,true,true,true,-1.0
1,2,0.5,0.5,false,false,300,300,298,298,-2,-2,2,true,true,true,-1.0
1,2,0.5,0.5,false,false,300,900,298,898,-2,-2,2,true,true,true,-1.0
1,2,0.5,0.5,false,false,250,350,248,348,-2,-2,2,false,false,false,-1.0
1,2,0.5,0.5,false,false,350,250,348,248,-2,-2,2,true,true,true,-1.0
1,2,0.5,0.5,false,false,300,850,298,848,-2,-2,2,true,true,true,-1.0
1,2,0.5,0.5,false,false,850,300,848,298,-2,-2,2,true,true,true,-1.0
1,2,0.5,0.5,false,false,900,200,900,200,0,0,0,true,true,true,-1.0
1,2,0.5,0.5,false,false,250,900,249,899,-1,-1,1,true,true,true,-1.0
1,2,0.5,0.5,false,false,250,300,299,799,49,499,1,true,true,true,-1.0
1,2,0.5,0.5,false,false,300,250,296,246,-4,-4,4,true,true,true,-1.0
1,2,0.5,0.5,false,false,850,250,850,250,0,0,0,true,true,true,-1.0
1,2,0.5,0.5,false,false,850,250,850,250,0,0,0,true,true,true,-1.0
2,0,0.5,0.5,true,false,850,200,845,195,-5,-5,5,true,true,true,617.235
2,0,0.5,0.5,true,false,300,300,300,300,0,0,0,true,true,true,-1.0
2,0,0.5,0.5,true,false,300,300,797,347,497,47,3,true,true,true,-1.0
2,0,0.5,0.5,true,false,300,900,797,947,497,47,3,true,true,true,-1.0
2,0,0.5,0.5,true,false,250,300,899,849,649,549,1,true,true,true,-1.0
2,0,0.5,0.5,true,false,250,300,899,849,649,549,1,true,true,true,-1.0
2,0,0.5,0.5,true,false,850,300,847,297,-3,-3,3,true,true,true,-1.0
2,0,0.5,0.5,true,false,350,350,345,345,-5,-5,5,true,true,true,-1.0
2,0,0.5,0.5,true,false,200,200,347,297,147,97,3,true,false,true,-1.0
2,0,0.5,0.5,true,false,200,250,197,247,-3,-3,3,true,true,true,-1.0
2,0,0.5,0.5,true,false,300,350,297,347,-3,-3,3,true,true,true,-1.0
2,0,0.5,0.5,true,false,200,250,249,799,49,549,1,true,true,true,-1.0
2,0,0.5,0.5,true,false,250,300,899,349,649,49,1,true,true,true,-1.0
2,0,0.5,0.5,true,false,850,250,845,245,-5,-5,5,true,true,true,-1.0
2,0,0.5,0.5,true,false,300,300,295,295,-5,-5,5,true,true,true,-1.0
2,0,0.5,0.5,true,false,350,300,345,295,-5,-5,5,true,true,true,-1.0
2,0,0.5,0.5,true,false,200,200,200,200,0,0,0,true,true,true,-1.0
2,0,0.5,0.5,true,false,350,200,897,297,547,97,3,true,true,true,-1.0
2,0,0.5,0.5,true,false,250,250,246,246,-4,-4,4,true,true,true,-1.0
2,0,0.5,0.5,true,false,300,300,300,300,0,0,0,true,true,true,-1.0
2,0,0.5,0.5,false,false,250,250,898,798,648,548,2,true,true,true,93.761
2,0,0.5,0.5,false,false,300,900,300,900,0,0,0,true,true,true,-1.0
2,0,0.5,0.5,false,false,350,250,397,297,47,47,3,true,true,true,-1.0
2,0,0.5,0.5,false,false,850,250,850,250,0,0,0,true,true,true,-1.0
2,0,0.5,0.5,false,false,250,200,247,197,-3,-3,3,true,true,true,-1.0
2,0,0.5,0.5,false,false,200,350,195,345,-5,-5,5,true,true,true,-1.0
2,0,0.5,0.5,false,false,300,200,297,197,-3,-3,3,false,false,false,-1.0
2,0,0.5,0.5,false,false,250,200,347,247,97,47,3,true,true,true,-1.0
2,0,0.5,0.5,false,false,250,850,250,850,0,0,0,true,true,true,-1.0
2,0,0.5,0.5,false,false,300,300,347,347,47,47,3,true,true,true,-1.0
2,0,0.5,0.5,false,false,300,300,296,296,-4,-4,4,true,true,true,-1.0
2,0,0.5,0.5,false,false,200,200,200,200,0,0,0,true,true,true,-1.0
2,0,0.5,0.5,false,false,850,850,847,847,-3,-3,3,true,true,true,-1.0
2,0,0.5,0.5,false,false,250,200,799,949,549,749,1,true,true,true,-1.0
2,0,0.5,0.5,false,false,300,300,295,295,-5,-5,5,true,true,true,-1.0
2,0,0.5,0.5,false,false,850,300,850,300,0,0,0,true,true,true,-1.0
2,0,0.5,0.5,false,false,250,200,245,195,-5,-5,5,true,true,true,-1.0
2,0,0.5,0.5,false,false,200,850,197,847,-3,-3,3,false,false,false,-1.0
2,0,0.5,0.5,false,false,250,850,246,846,-4,-4,4,true,true,true,-1.0
2,0,0.5,0.5,false,false,850,300,899,799,49,499,1,true,true,true,-1.0
2,1,0.5,0.5,true,false,300,300,798,348,498,48,2,true,true,true,838.286
2,1,0.5,0.5,true,false,300,200,797,347,497,147,3,true,true,true,-1.0
2,1,0.5,0.5,true,false,250,300,797,897,547,597,3,true,true,true,-1.0
2,1,0.5,0.5,true,false,300,300,799,899,499,599,1,true,true,true,-1.0
2,1,0.5,0.5,true,false,300,300,297,297,-3,-3,3,true,true,true,-1.0
2,1,0.5,0.5,true,false,900,300,897,297,-3,-3,3,true,true,true,-1.0
2,1,0.5,0.5,true,false,850,200,850,200,0,0,0,true,true,true,-1.0
2,1,0.5,0.5,true,false,200,300,798,898,598,598,2,true,true,true,-1.0
2,1,0.5,0.5,true,false,350,200,350,200,0,0,0,true,true,true,-1.0
2,1,0.5,0.5,true,false,350,300,300,250,-50,-50,50,false,false,false,-1.0
2,1,0.5,0.5,true,false,300,300,297,297,-3,-3,3,true,true,true,-1.0
2,1,0.5,0.5,true,false,350,350,345,345,-5,-5,5,true,true,true,-1.0
2,1,0.5,0.5,true,false,250,850,247,847,-3,-3,3,true,true,true,-1.0
2,1,0.5,0.5,true,false,250,200,247,197,-3,-3,3,true,true,true,-1.0
2,1,0.5,0.5,true,false,850,300,847,297,-3,-3,3,true,true,true,-1.0
2,1,0.5,0.5,true,false,250,200,247,197,-3,-3,3,true,true,true,-1.0
2,1,0.5,0.5,true,false,300,900,297,897,-3,-3,3,true,true,true,-1.0
2,1,0.5,0.5,true,false,350,300,948,798,598,498,2,true,true,true,-1.0
2,1,0.5,0.5,true,false,350,300,347,297,-3,-3,3,true,true,true,-1.0
2,1,0.5,0.5,true,false,850,850,847,847,-3,-3,3,true,true,true,-1.0
2,1,0.5,0.5,false,false,350,350,300,300,-50,-50,50,true,true,true,128.101
2,1,0.5,0.5,false,false,300,200,797,297,497,97,3,true,true,true,-1.0
2,1,0.5,0.5,false,false,350,250,398,798,48,548,2,true,true,true,-1.0
2,1,0.5,0.5,false,false,200,200,197,197,-3,-3,3,true,true,true,-1.0
2,1,0.5,0.5,false,false,250,300,250,300,0,0,0,true,true,true,-1.0
2,1,0.5,0.5,false,false,300,200,348,798,48,598,2,true,true,true,-1.0
2,1,0.5,0.5,false,false,850,300,847,297,-3,-3,3,true,true,true,-1.0
2,1,0.5,0.5,false,false,350,350,350,350,0,0,0,true,true,true,-1.0
2,1,0.5,0.5,false,false,300,200,799,249,499,49,1,true,true,true,-1.0
2,1,0.5,0.5,false,false,200,300,248,798,48,498,2,true,true,true,-1.0
2,1,0.5,0.5,false,false,850,850,847,847,-3,-3,3,true,true,true,-1.0
2,1,0.5,0.5,false,false,200,250,150,200,-50,-50,50,false,false,false,-1.0
2,1,0.5,0.5,false,false,200,300,281,781,81,481,19,true,true,true,-1.0
2,1,0.5,0.5,false,false,250,250,798,348,548,98,2,true,true,true,-1.0
2,1,0.5,0.5,false,false,300,300,799,349,499,49,1,true,true,true,-1.0
2,1,0.5,0.5,false,false,300,850,299,849,-1,-1,1,true,true,true,-1.0
2,1,0.5,0.5,false,false,200,250,849,849,649,599,1,true,true,true,-1.0
2,1,0.5,0.5,false,false,300,300,250,250,-50,-50,50,false,false,false,-1.0
2,1,0.5,0.5,false,false,300,300,296,296,-4,-4,4,true,true,true,-1.0
2,1,0.5,0.5,false,false,200,250,249,299,49,49,1,true,true,true,-1.0
2,2,0.5,0.5,true,true,200,850,198,848,-2,-2,2,true,true,true,482.288
2,2,0.5,0.5,true,true,300,300,799,899,499,599,1,true,true,true,-1.0
2,2,0.5,0.5,true,true,850,200,850,200,0,0,0,true,true,true,-1.0
2,2,0.5,0.5,true,true,300,300,299,299,-1,-1,1,true,true,true,-1.0
2,2,0.5,0.5,true,true,200,350,199,349,-1,-1,1,true,true,true,-1.0
2,2,0.5,0.5,true,true,300,300,299,299,-1,-1,1,true,true,true,-1.0
2,2,0.5,0.5,true,true,350,350,350,350,0,0,0,true,true,true,-1.0
2,2,0.5,0.5,true,true,300,300,297,297,-3,-3,3,true,true,true,-1.0
2,2,0.5,0.5,true,true,200,300,349,799,149,499,1,true,true,true,-1.0
2,2,0.5,0.5,true,true,850,350,849,349,-1,-1,1,true,true,true,-1.0
2,2,0.5,0.5,true,true,200,250,200,250,0,0,0,true,true,true,-1.0
2,2,0.5,0.5,true,true,300,300,299,299,-1,-1,1,true,true,true,-1.0
2,2,0.5,0.5,true,true,850,250,850,250,0,0,0,true,true,true,-1.0
2,2,0.5,0.5,true,true,350,250,399,299,49,49,1,true,true,true,-1.0
2,2,0.5,0.5,true,true,300,200,348,298,48,98,2,true,true,true,-1.0
2,2,0.5,0.5,true,true,850,300,899,799,49,499,1,true,true,true,-1.0
2,2,0.5,0.5,true,true,300,350,796,946,496,596,4,true,true,true,-1.0
2,2,0.5,0.5,true,true,200,850,199,849,-1,-1,1,true,true,true,-1.0
2,2,0.5,0.5,true,true,250,200,299,249,49,49,1,true,true,true,-1.0
2,2,0.5,0.5,true,true,300,250,899,899,599,649,1,true,true,true,-1.0
2,2,0.5,0.5,true,false,250,850,798,898,548,48,2,true,true,true,471.512
2,2,0.5,0.5,true,false,300,850,299,849,-1,-1,1,true,true,true,-1.0
2,2,0.5,0.5,true,false,200,350,198,348,-2,-2,2,true,true,true,-1.0
2,2,0.5,0.5,true,false,900,300,898,298,-2,-2,2,true,true,true,-1.0
2,2,0.5,0.5,true,false,300,300,348,798,48,498,2,true,true,true,-1.0
2,2,0.5,0.5,true,false,300,850,299,849,-1,-1,1,true,true,true,-1.0
2,2,0.5,0.5,true,false,200,200,200,200,0,0,0,true,true,true,-1.0
2,2,0.5,0.5,true,false,200,250,150,200,-50,-50,50,false,false,false,-1.0
2,2,0.5,0.5,true,false,200,850,199,849,-1,-1,1,true,true,true,-1.0
2,2,0.5,0.5,true,false,300,250,300,250,0,0,0,true,true,true,-1.0
2,2,0.5,0.5,true,false,200,200,799,249,599,49,1,true,true,true,-1.0
2,2,0.5,0.5,true,false,300,200,887,237,587,37,13,true,true,true,-1.0
2,2,0.5,0.5,true,false,250,850,248,848,-2,-2,2,true,true,true,-1.0
2,2,0.5,0.5,true,false,300,250,899,299,599,49,1,true,true,true,-1.0
2,2,0.5,0.5,true,false,300,300,299,299,-1,-1,1,true,true,true,-1.0
2,2,0.5,0.5,true,false,300,900,798,948,498,48,2,true,true,true,-1.0
2,2,0.5,0.5,true,false,300,200,798,898,498,698,2,true,true,true,-1.0
2,2,0.5,0.5,true,false,350,200,899,249,549,49,1,true,true,true,-1.0
2,2,0.5,0.5,true,false,300,850,299,849,-1,-1,1,true,true,true,-1.0
2,2,0.5,0.5,true,false,300,850,299,849,-1,-1,1,true,true,true,-1.0
2,2,0.5,0.5,false,true,200,250,249,799,49,549,1,true,true,true,133.889
2,2,0.5,0.5,false,true,850,350,849,349,-1,-1,1,true,true,true,-1.0
2,2,0.5,0.5,false,true,250,200,298,348,48,148,2,true,false,true,-1.0
2,2,0.5,0.5,false,true,200,350,798,398,598,48,2,true,true,true,-1.0
2,2,0.5,0.5,false,true,850,850,849,849,-1,-1,1,true,true,true,-1.0
2,2,0.5,0.5,false,true,300,250,797,897,497,647,3,true,true,true,-1.0
2,2,0.5,0.5,false,true,300,200,299,199,-1,-1,1,true,true,true,-1.0
2,2,0.5,0.5,false,true,250,850,798,898,548,48,2,true,true,true,-1.0
2,2,0.5,0.5,false,true,300,250,798,398,498,148,2,true,true,true,-1.0
2,2,0.5,0.5,false,true,300,250,848,848,548,598,2,true,true,true,-1.0
2,2,0.5,0.5,false,true,850,850,849,849,-1,-1,1,true,true,true,-1.0
2,2,0.5,0.5,false,true,900,350,899,349,-1,-1,1,true,true,true,-1.0
2,2,0.5,0.5,false,true,300,350,348,898,48,548,2,true,true,true,-1.0
2,2,0.5,0.5,false,true,300,350,797,397,497,47,3,true,true,true,-1.0
2,2,0.5,0.5,false,true,900,200,900,200,0,0,0,true,true,true,-1.0
2,2,0.5,0.5,false,true,200,200,298,248,98,48,2,true,true,true,-1.0
2,2,0.5,0.5,false,true,300,300,299,299,-1,-1,1,true,true,true,-1.0
2,2,0.5,0.5,false,true,300,200,349,799,49,599,1,true,true,true,-1.0
2,2,0.5,0.5,false,true,200,200,348,298,148,98,2,true,true,true,-1.0
2,2,0.5,0.5,false,true,300,300,798,348,498,48,2,true,true,true,-1.0
2,2,0.5,0.5,false,false,300,200,300,200,0,0,0,true,true,true,132.17
2,2,0.5,0.5,false,false,250,200,798,248,548,48,2,true,true,true,-1.0
2,2,0.5,0.5,false,false,300,250,349,299,49,49,1,true,true,true,-1.0
2,2,0.5,0.5,false,false,850,300,898,798,48,498,2,true,true,true,-1.0
2,2,0.5,0.5,false,false,350,250,349,249,-1,-1,1,true,true,true,-1.0
2,2,0.5,0.5,false,false,200,850,198,848,-2,-2,2,true,true,true,-1.0
2,2,0.5,0.5,false,false,250,200,200,150,-50,-50,50,false,false,false,-1.0
2,2,0.5,0.5,false,false,250,200,798,948,548,748,2,true,true,true,-1.0
2,2,0.5,0.5,false,false,250,300,297,347,47,47,3,true,true,true,-1.0
2,2,0.5,0.5,false,false,850,250,850,250,0,0,0,true,true,true,-1.0
2,2,0.5,0.5,false,false,300,300,798,898,498,598,2,true,true,true,-1.0
2,2,0.5,0.5,false,false,300,300,348,798,48,498,2,true,true,true,-1.0
2,2,0.5,0.5,false,false,300,300,799,899,499,599,1,true,true,true,-1.0
2,2,0.5,0.5,false,false,200,350,248,398,48,48,2,true,true,true,-1.0
2,2,0.5,0.5,false,false,300,200,787,337,487,137,13,true,true,true,-1.0
2,2,0.5,0.5,false,false,300,850,298,848,-2,-2,2,true,true,true,-1.0
2,2,0.5,0.5,false,false,200,300,248,798,48,498,2,true,true,true,-1.0
2,2,0.5,0.5,false,false,200,200,898,798,698,598,2,true,true,true,-1.0
2,2,0.5,0.5,false,false,200,300,248,798,48,498,2,true,true,true,-1.0
2,2,0.5,0.5,false,false,850,300,848,298,-2,-2,2,true,true,true,-1.0
0,0,0.5,0.5,false,false,200,200,197,197,-3,-3,3,true,true,true,0.207
0,0,0.5,0.5,false,false,300,250,898,298,598,48,2,true,true,true,-1.0
0,0,0.5,0.5,false,false,250,850,247,847,-3,-3,3,true,true,true,-1.0
0,0,0.5,0.5,false,false,300,350,296,346,-4,-4,4,true,true,true,-1.0
0,0,0.5,0.5,false,false,250,300,298,798,48,498,2,true,true,true,-1.0
0,0,0.5,0.5,false,false,350,200,396,246,46,46,4,true,false,true,-1.0
0,0,0.5,0.5,false,false,300,200,347,247,47,47,3,true,true,true,-1.0
0,0,0.5,0.5,false,false,200,850,198,848,-2,-2,2,true,true,true,-1.0
0,0,0.5,0.5,false,false,350,850,347,847,-3,-3,3,true,true,true,-1.0
0,0,0.5,0.5,false,false,900,250,898,248,-2,-2,2,true,true,true,-1.0
0,0,0.5,0.5,false,false,250,250,797,347,547,97,3,true,true,true,-1.0
0,0,0.5,0.5,false,false,200,350,248,948,48,598,2,true,true,true,-1.0
0,0,0.5,0.5,false,false,850,300,848,298,-2,-2,2,true,true,true,-1.0
0,0,0.5,0.5,false,false,250,250,247,247,-3,-3,3,false,false,false,-1.0
0,0,0.5,0.5,false,false,350,850,347,847,-3,-3,3,true,true,true,-1.0
0,0,0.5,0.5,false,false,350,350,346,346,-4,-4,4,true,true,true,-1.0
0,0,0.5,0.5,false,false,300,300,296,296,-4,-4,4,false,false,false,-1.0
0,0,0.5,0.5,false,false,200,200,197,197,-3,-3,3,false,false,false,-1.0
0,0,0.5,0.5,false,false,250,300,247,297,-3,-3,3,true,true,true,-1.0
0,0,0.5,0.5,false,false,300,350,297,347,-3,-3,3,true,true,true,-1.0
0,1,0.5,0.5,false,false,300,200,296,196,-4,-4,4,true,true,true,0.278
0,1,0.5,0.5,false,false,250,900,249,899,-1,-1,1,true,true,true,-1.0
0,1,0.5,0.5,false,false,300,350,296,346,-4,-4,4,true,true,true,-1.0
0,1,0.5,0.5,false,false,250,300,246,296,-4,-4,4,true,true,true,-1.0
0,1,0.5,0.5,false,false,250,200,349,799,99,599,1,true,true,true,-1.0
0,1,0.5,0.5,false,false,200,850,196,846,-4,-4,4,true,true,true,-1.0
0,1,0.5,0.5,false,false,200,350,248,898,48,548,2,true,true,true,-1.0
0,1,0.5,0.5,false,false,350,250,947,297,597,47,3,true,true,true,-1.0
0,1,0.5,0.5,false,false,900,250,948,798,48,548,2,true,true,true,-1.0
0,1,0.5,0.5,false,false,850,300,846,296,-4,-4,4,true,true,true,-1.0
0,1,0.5,0.5,false,false,300,250,346,296,46,46,4,true,true,true,-1.0
0,1,0.5,0.5,false,false,200,300,799,899,599,599,1,true,true,true,-1.0
0,1,0.5,0.5,false,false,300,200,296,196,-4,-4,4,false,false,false,-1.0
0,1,0.5,0.5,false,false,300,850,296,846,-4,-4,4,true,true,true,-1.0
0,1,0.5,0.5,false,false,200,300,248,798,48,498,2,true,true,true,-1.0
0,1,0.5,0.5,false,false,300,350,296,346,-4,-4,4,true,true,true,-1.0
0,1,0.5,0.5,false,false,850,300,846,296,-4,-4,4,true,true,true,-1.0
0,1,0.5,0.5,false,false,300,850,296,846,-4,-4,4,true,true,true,-1.0
0,1,0.5,0.5,false,false,850,200,848,198,-2,-2,2,true,true,true,-1.0
0,1,0.5,0.5,false,false,200,300,199,299,-1,-1,1,true,true,true,-1.0
0,2,0.5,0.5,false,true,200,300,196,296,-4,-4,4,false,false,false,414.288
0,2,0.5,0.5,false,true,900,900,896,896,-4,-4,4,true,true,true,-1.0
0,2,0.5,0.5,false,true,300,250,296,246,-4,-4,4,true,true,true,-1.0
0,2,0.5,0.5,false,true,300,200,299,199,-1,-1,1,true,true,true,-1.0
0,2,0.5,0.5,false,true,300,250,296,246,-4,-4,4,true,true,true,-1.0
0,2,0.5,0.5,false,true,200,850,199,849,-1,-1,1,true,true,true,-1.0
0,2,0.5,0.5,false,true,250,850,246,846,-4,-4,4,true,true,true,-1.0
0,2,0.5,0.5,false,true,850,250,849,249,-1,-1,1,true,true,true,-1.0
0,2,0.5,0.5,false,true,250,850,799,899,549,49,1,true,true,true,-1.0
0,2,0.5,0.5,false,true,250,850,246,846,-4,-4,4,true,true,true,-1.0
0,2,0.5,0.5,false,true,300,250,298,248,-2,-2,2,true,true,true,-1.0
0,2,0.5,0.5,false,true,300,200,348,348,48,148,2,true,false,true,-1.0
0,2,0.5,0.5,false,true,850,200,848,198,-2,-2,2,true,true,true,-1.0
0,2,0.5,0.5,false,true,300,200,296,196,-4,-4,4,false,false,false,-1.0
0,2,0.5,0.5,false,true,250,300,799,899,549,599,1,true,true,true,-1.0
0,2,0.5,0.5,false,true,200,300,198,298,-2,-2,2,true,true,true,-1.0
0,2,0.5,0.5,false,true,850,300,848,298,-2,-2,2,true,true,true,-1.0
0,2,0.5,0.5,false,true,850,300,846,296,-4,-4,4,true,true,true,-1.0
0,2,0.5,0.5,false,true,250,300,899,849,649,549,1,true,true,true,-1.0
0,2,0.5,0.5,false,true,300,300,296,296,-4,-4,4,true,true,true,-1.0
0,2,0.5,0.5,false,false,250,250,246,246,-4,-4,4,true,true,true,78.904
0,2,0.5,0.5,false,false,250,250,298,848,48,598,2,true,true,true,-1.0
0,2,0.5,0.5,false,false,300,300,296,296,-4,-4,4,true,true,true,-1.0
0,2,0.5,0.5,false,false,300,300,348,798,48,498,2,true,true,true,-1.0
0,2,0.5,0.5,false,false,250,850,247,847,-3,-3,3,true,true,true,-1.0
0,2,0.5,0.5,false,false,200,300,196,296,-4,-4,4,true,true,true,-1.0
0,2,0.5,0.5,false,false,850,850,846,846,-4,-4,4,true,true,true,-1.0
0,2,0.5,0.5,false,false,250,850,247,847,-3,-3,3,true,true,true,-1.0
0,2,0.5,0.5,false,false,200,200,196,196,-4,-4,4,true,true,true,-1.0
0,2,0.5,0.5,false,false,200,350,248,948,48,598,2,true,false,true,-1.0
0,2,0.5,0.5,false,false,850,250,848,248,-2,-2,2,true,true,true,-1.0
0,2,0.5,0.5,false,false,350,350,346,346,-4,-4,4,true,true,true,-1.0
0,2,0.5,0.5,false,false,300,850,296,846,-4,-4,4,true,true,true,-1.0
0,2,0.5,0.5,false,false,850,300,898,798,48,498,2,true,true,true,-1.0
0,2,0.5,0.5,false,false,350,850,347,847,-3,-3,3,true,true,true,-1.0
0,2,0.5,0.5,false,false,300,350,296,346,-4,-4,4,true,true,true,-1.0
0,2,0.5,0.5,false,false,200,300,197,297,-3,-3,3,true,true,true,-1.0
0,2,0.5,0.5,false,false,900,200,896,196,-4,-4,4,true,true,true,-1.0
0,2,0.5,0.5,false,false,200,250,348,798,148,548,2,true,true,true,-1.0
0,2,0.5,0.5,false,false,300,250,296,246,-4,-4,4,true,true,true,-1.0
1,0,0.5,0.5,false,false,200,250,249,349,49,99,1,true,false,true,0.269
1,0,0.5,0.5,false,false,300,300,398,798,98,498,2,true,true,true,-1.0
1,0,0.5,0.5,false,false,250,250,796,296,546,46,4,true,true,true,-1.0
1,0,0.5,0.5,false,false,850,850,850,850,0,0,0,true,true,true,-1.0
1,0,0.5,0.5,false,false,350,300,899,849,549,549,1,true,true,true,-1.0
1,0,0.5,0.5,false,false,250,850,799,899,549,49,1,true,true,true,-1.0
1,0,0.5,0.5,false,false,350,300,399,799,49,499,1,true,true,true,-1.0
1,0,0.5,0.5,false,false,200,200,197,197,-3,-3,3,true,true,true,-1.0
1,0,0.5,0.5,false,false,850,200,845,195,-5,-5,5,true,true,true,-1.0
1,0,0.5,0.5,false,false,250,300,799,899,549,599,1,true,true,true,-1.0
1,0,0.5,0.5,false,false,350,250,397,297,47,47,3,true,true,true,-1.0
1,0,0.5,0.5,false,false,200,200,197,197,-3,-3,3,true,true,true,-1.0
1,0,0.5,0.5,false,false,900,200,900,200,0,0,0,true,true,true,-1.0
1,0,0.5,0.5,false,false,850,200,846,196,-4,-4,4,true,true,true,-1.0
1,0,0.5,0.5,false,false,300,300,297,297,-3,-3,3,true,true,true,-1.0
1,0,0.5,0.5,false,false,250,250,297,297,47,47,3,true,true,true,-1.0
1,0,0.5,0.5,false,false,300,300,898,848,598,548,2,true,true,true,-1.0
1,0,0.5,0.5,false,false,200,850,197,847,-3,-3,3,true,true,true,-1.0
1,0,0.5,0.5,false,false,200,300,398,798,198,498,2,true,true,true,-1.0
1,0,0.5,0.5,false,false,350,350,347,347,-3,-3,3,true,true,true,-1.0
1,1,0.5,0.5,false,false,300,850,300,850,0,0,0,true,true,true,1.514
1,1,0.5,0.5,false,false,300,250,799,899,499,649,1,true,true,true,-1.0
1,1,0.5,0.5,false,false,300,900,799,949,499,49,1,true,true,true,-1.0
1,1,0.5,0.5,false,false,300,850,250,800,-50,-50,50,true,true,true,-1.0
1,1,0.5,0.5,false,false,350,350,350,350,0,0,0,true,true,true,-1.0
1,1,0.5,0.5,false,false,250,300,299,799,49,499,1,true,true,true,-1.0
1,1,0.5,0.5,false,false,850,850,850,850,0,0,0,true,true,true,-1.0
1,1,0.5,0.5,false,false,300,300,300,300,0,0,0,true,true,true,-1.0
1,1,0.5,0.5,false,false,250,250,298,798,48,548,2,true,true,true,-1.0
1,1,0.5,0.5,false,false,300,250,250,200,-50,-50,50,true,true,true,-1.0
1,1,0.5,0.5,false,false,300,350,250,300,-50,-50,50,false,false,false,-1.0
1,1,0.5,0.5,false,false,300,250,799,299,499,49,1,true,true,true,-1.0
1,1,0.5,0.5,false,false,300,300,297,297,-3,-3,3,true,true,true,-1.0
1,1,0.5,0.5,false,false,300,300,799,899,499,599,1,true,true,true,-1.0
1,1,0.5,0.5,false,false,300,350,799,399,499,49,1,true,true,true,-1.0
1,1,0.5,0.5,false,false,200,250,798,898,598,648,2,true,true,true,-1.0
1,1,0.5,0.5,false,false,850,300,848,298,-2,-2,2,true,true,true,-1.0
1,1,0.5,0.5,false,false,900,850,899,849,-1,-1,1,true,true,true,-1.0
1,1,0.5,0.5,false,false,200,300,348,798,148,498,2,true,true,true,-1.0
1,1,0.5,0.5,false,false,250,850,200,800,-50,-50,50,true,true,true,-1.0
1,2,0.5,0.5,false,true,250,250,799,949,549,699,1,true,true,true,603.831
1,2,0.5,0.5,false,true,250,250,299,299,49,49,1,true,true,true,-1.0
1,2,0.5,0.5,false,true,350,300,348,298,-2,-2,2,true,true,true,-1.0
1,2,0.5,0.5,false,true,850,250,898,798,48,548,2,true,true,true,-1.0
1,2,0.5,0.5,false,true,300,300,296,296,-4,-4,4,true,true,true,-1.0
1,2,0.5,0.5,false,true,850,300,850,300,0,0,0,true,true,true,-1.0
1,2,0.5,0.5,false,true,850,300,848,298,-2,-2,2,true,true,true,-1.0
1,2,0.5,0.5,false,true,250,300,250,300,0,0,0,true,true,true,-1.0
1,2,0.5,0.5,false,true,200,250,196,246,-4,-4,4,true,true,true,-1.0
1,2,0.5,0.5,false,true,300,300,346,796,46,496,4,true,true,true,-1.0
1,2,0.5,0.5,false,true,850,200,899,799,49,599,1,true,true,true,-1.0
1,2,0.5,0.5,false,true,200,300,198,298,-2,-2,2,true,true,true,-1.0
1,2,0.5,0.5,false,true,200,200,200,200,0,0,0,true,true,true,-1.0
1,2,0.5,0.5,false,true,300,300,300,300,0,0,0,true,true,true,-1.0
1,2,0.5,0.5,false,true,200,350,198,348,-2,-2,2,true,true,true,-1.0
1,2,0.5,0.5,false,true,350,200,348,198,-2,-2,2,true,true,true,-1.0
1,2,0.5,0.5,false,true,350,200,949,299,599,99,1,true,true,true,-1.0
1,2,0.5,0.5,false,true,200,200,200,200,0,0,0,true,true,true,-1.0
1,2,0.5,0.5,false,true,300,300,298,298,-2,-2,2,true,true,true,-1.0
1,2,0.5,0.5,false,true,300,850,299,849,-1,-1,1,true,true,true,-1.0
1,2,0.5,0.5,false,false,300,850,799,899,499,49,1,true,true,true,127.694
1,2,0.5,0.5,false,false,250,250,250,250,0,0,0,true,true,true,-1.0
1,2,0.5,0.5,false,false,300,300,347,797,47,497,3,true,true,true,-1.0
1,2,0.5,0.5,false,false,350,250,898,348,548,98,2,true,true,true,-1.0
1,2,0.5,0.5,false,false,250,850,248,848,-2,-2,2,true,true,true,-1.0
1,2,0.5,0.5,false,false,250,200,297,247,47,47,3,true,true,true,-1.0
1,2,0.5,0.5,false,false,850,250,850,250,0,0,0,true,true,true,-1.0
1,2,0.5,0.5,false,false,300,250,398,798,98,548,2,true,true,true,-1.0
1,2,0.5,0.5,false,false,250,250,200,200,-50,-50,50,false,false,false,-1.0
1,2,0.5,0.5,false,false,300,900,298,898,-2,-2,2,true,true,true,-1.0
1,2,0.5,0.5,false,false,850,850,848,848,-2,-2,2,true,true,true,-1.0
1,2,0.5,0.5,false,false,250,850,248,848,-2,-2,2,true,true,true,-1.0
1,2,0.5,0.5,false,false,300,200,300,200,0,0,0,true,true,true,-1.0
1,2,0.5,0.5,false,false,350,300,350,300,0,0,0,true,true,true,-1.0
1,2,0.5,0.5,false,false,300,250,300,250,0,0,0,true,true,true,-1.0
1,2,0.5,0.5,false,false,200,300,198,298,-2,-2,2,true,true,true,-1.0
1,2,0.5,0.5,false,false,250,350,248,348,-2,-2,2,true,true,true,-1.0
1,2,0.5,0.5,false,false,850,300,850,300,0,0,0,true,true,true,-1.0
1,2,0.5,0.5,false,false,850,300,850,300,0,0,0,true,true,true,-1.0
1,2,0.5,0.5,false,false,300,250,300,250,0,0,0,true,true,true,-1.0
2,0,0.5,0.5,true,false,250,300,245,295,-5,-5,5,true,true,true,509.415
2,0,0.5,0.5,true,false,200,200,797,247,597,47,3,true,true,true,-1.0
2,0,0.5,0.5,true,false,300,300,300,300,0,0,0,true,true,true,-1.0
2,0,0.5,0.5,true,false,250,300,245,295,-5,-5,5,true,true,true,-1.0
2,0,0.5,0.5,true,false,250,250,250,250,0,0,0,true,true,true,-1.0
2,0,0.5,0.5,true,false,900,200,895,195,-5,-5,5,true,true,true,-1.0
2,0,0.5,0.5,true,false,850,250,850,250,0,0,0,true,true,true,-1.0
2,0,0.5,0.5,true,false,300,300,295,295,-5,-5,5,true,true,true,-1.0
2,0,0.5,0.5,true,false,300,250,297,247,-3,-3,3,false,false,false,-1.0
2,0,0.5,0.5,true,false,200,250,197,247,-3,-3,3,true,true,true,-1.0
2,0,0.5,0.5,true,false,850,200,847,197,-3,-3,3,true,true,true,-1.0
2,0,0.5,0.5,true,false,300,300,897,797,597,497,3,true,true,true,-1.0
2,0,0.5,0.5,true,false,850,300,845,295,-5,-5,5,true,true,true,-1.0
2,0,0.5,0.5,true,false,250,300,299,799,49,499,1,true,true,true,-1.0
2,0,0.5,0.5,true,false,300,300,295,295,-5,-5,5,true,true,true,-1.0
2,0,0.5,0.5,true,false,300,850,297,847,-3,-3,3,true,true,true,-1.0
2,0,0.5,0.5,true,false,850,850,847,847,-3,-3,3,true,true,true,-1.0
2,0,0.5,0.5,true,false,300,250,897,297,597,47,3,true,true,true,-1.0
2,0,0.5,0.5,true,false,200,850,197,847,-3,-3,3,true,true,true,-1.0
2,0,0.5,0.5,true,false,250,350,245,345,-5,-5,5,true,true,true,-1.0
2,0,0.5,0.5,false,false,300,850,300,850,0,0,0,true,true,true,89.988
2,0,0.5,0.5,false,false,200,250,197,247,-3,-3,3,true,true,true,-1.0
2,0,0.5,0.5,false,false,350,300,350,300,0,0,0,true,true,true,-1.0
2,0,0.5,0.5,false,false,250,850,296,896,46,46,4,true,true,true,-1.0
2,0,0.5,0.5,false,false,850,250,845,245,-5,-5,5,true,true,true,-1.0
2,0,0.5,0.5,false,false,350,850,347,847,-3,-3,3,true,true,true,-1.0
2,0,0.5,0.5,false,false,200,850,197,847,-3,-3,3,false,false,false,-1.0
2,0,0.5,0.5,false,false,300,900,297,897,-3,-3,3,true,true,true,-1.0
2,0,0.5,0.5,false,false,300,300,295,295,-5,-5,5,true,true,true,-1.0
2,0,0.5,0.5,false,false,850,200,899,799,49,599,1,true,true,true,-1.0
2,0,0.5,0.5,false,false,350,900,347,897,-3,-3,3,true,true,true,-1.0
2,0,0.5,0.5,false,false,200,250,197,247,-3,-3,3,true,true,true,-1.0
2,0,0.5,0.5,false,false,850,250,850,250,0,0,0,true,true,true,-1.0
2,0,0.5,0.5,false,false,250,850,247,847,-3,-3,3,true,true,true,-1.0
2,0,0.5,0.5,false,false,250,300,299,799,49,499,1,true,true,true,-1.0
2,0,0.5,0.5,false,false,850,300,850,300,0,0,0,true,true,true,-1.0
2,0,0.5,0.5,false,false,300,300,797,347,497,47,3,true,true,true,-1.0
2,0,0.5,0.5,false,false,200,250,248,798,48,548,2,true,true,true,-1.0
2,0,0.5,0.5,false,false,850,850,847,847,-3,-3,3,true,true,true,-1.0
2,0,0.5,0.5,false,false,200,300,197,297,-3,-3,3,true,true,true,-1.0
2,1,0.5,0.5,true,false,300,350,297,347,-3,-3,3,true,true,true,998.189
2,1,0.5,0.5,true,false,200,300,197,297,-3,-3,3,true,true,true,-1.0
2,1,0.5,0.5,true,false,300,250,297,247,-3,-3,3,true,true,true,-1.0
2,1,0.5,0.5,true,false,900,250,900,250,0,0,0,true,true,true,-1.0
2,1,0.5,0.5,true,false,300,250,349,299,49,49,1,true,false,true,-1.0
2,1,0.5,0.5,true,false,250,300,250,300,0,0,0,true,true,true,-1.0
2,1,0.5,0.5,true,false,850,300,847,297,-3,-3,3,true,true,true,-1.0
2,1,0.5,0.5,true,false,300,200,300,200,0,0,0,true,true,true,-1.0
2,1,0.5,0.5,true,false,350,300,349,299,-1,-1,1,true,true,true,-1.0
2,1,0.5,0.5,true,false,900,200,900,200,0,0,0,true,true,true,-1.0
2,1,0.5,0.5,true,false,250,200,399,299,149,99,1,true,false,true,-1.0
2,1,0.5,0.5,true,false,250,300,799,899,549,599,1,true,true,true,-1.0
2,1,0.5,0.5,true,false,300,300,271,271,-29,-29,29,true,true,true,-1.0
2,1,0.5,0.5,true,false,300,200,799,249,499,49,1,true,true,true,-1.0
2,1,0.5,0.5,true,false,200,250,298,798,98,548,2,true,true,true,-1.0
2,1,0.5,0.5,true,false,850,250,847,247,-3,-3,3,true,true,true,-1.0
2,1,0.5,0.5,true,false,300,300,250,250,-50,-50,50,false,false,false,-1.0
2,1,0.5,0.5,true,false,850,350,847,347,-3,-3,3,true,true,true,-1.0
2,1,0.5,0.5,true,false,300,350,797,397,497,47,3,true,true,true,-1.0
2,1,0.5,0.5,true,false,850,300,898,798,48,498,2,true,true,true,-1.0
2,1,0.5,0.5,false,false,250,250,298,798,48,548,2,true,true,true,109.513
2,1,0.5,0.5,false,false,250,200,247,197,-3,-3,3,true,true,true,-1.0
2,1,0.5,0.5,false,false,250,200,252,852,2,652,48,true,true,true,-1.0
2,1,0.5,0.5,false,false,250,300,298,798,48,498,2,true,true,true,-1.0
2,1,0.5,0.5,false,false,250,250,250,250,0,0,0,true,true,true,-1.0
2,1,0.5,0.5,false,false,250,200,799,249,549,49,1,true,true,true,-1.0
2,1,0.5,0.5,false,false,200,900,197,897,-3,-3,3,true,true,true,-1.0
2,1,0.5,0.5,false,false,200,300,248,798,48,498,2,true,true,true,-1.0
2,1,0.5,0.5,false,false,200,350,197,347,-3,-3,3,true,true,true,-1.0
2,1,0.5,0.5,false,false,350,250,898,848,548,598,2,true,true,true,-1.0
2,1,0.5,0.5,false,false,250,300,298,798,48,498,2,true,true,true,-1.0
2,1,0.5,0.5,false,false,900,250,900,250,0,0,0,true,true,true,-1.0
2,1,0.5,0.5,false,false,300,200,300,200,0,0,0,true,true,true,-1.0
2,1,0.5,0.5,false,false,300,300,300,300,0,0,0,true,true,true,-1.0
2,1,0.5,0.5,false,false,200,850,298,898,98,48,2,true,true,true,-1.0
2,1,0.5,0.5,false,false,850,250,847,247,-3,-3,3,true,true,true,-1.0
2,1,0.5,0.5,false,false,250,250,799,299,549,49,1,true,true,true,-1.0
2,1,0.5,0.5,false,false,300,200,898,798,598,598,2,true,true,true,-1.0
2,1,0.5,0.5,false,false,200,200,200,200,0,0,0,true,true,true,-1.0
2,1,0.5,0.5,false,false,250,200,847,247,597,47,3,true,false,true,-1.0
2,2,0.5,0.5,true,true,250,200,849,849,599,649,1,true,true,true,746.542
2,2,0.5,0.5,true,true,350,200,350,200,0,0,0,true,true,true,-1.0
2,2,0.5,0.5,true,true,300,300,798,348,498,48,2,true,true,true,-1.0
2,2,0.5,0.5,true,true,850,250,850,250,0,0,0,true,true,true,-1.0
2,2,0.5,0.5,true,true,250,900,798,948,548,48,2,true,true,true,-1.0
2,2,0.5,0.5,true,true,850,250,899,799,49,549,1,true,true,true,-1.0
2,2,0.5,0.5,true,true,350,300,949,799,599,499,1,true,true,true,-1.0
2,2,0.5,0.5,true,true,250,300,298,798,48,498,2,true,true,true,-1.0
2,2,0.5,0.5,true,true,900,300,899,299,-1,-1,1,true,true,true,-1.0
2,2,0.5,0.5,true,true,350,250,399,299,49,49,1,true,true,true,-1.0
2,2,0.5,0.5,true,true,850,300,849,299,-1,-1,1,true,true,true,-1.0
2,2,0.5,0.5,true,true,900,250,900,250,0,0,0,true,true,true,-1.0
2,2,0.5,0.5,true,true,250,300,298,848,48,548,2,true,true,true,-1.0
2,2,0.5,0.5,true,true,250,200,799,899,549,699,1,true,true,true,-1.0
2,2,0.5,0.5,true,true,850,200,847,197,-3,-3,3,true,true,true,-1.0
2,2,0.5,0.5,true,true,300,300,348,798,48,498,2,true,true,true,-1.0
2,2,0.5,0.5,true,true,300,200,899,249,599,49,1,true,true,true,-1.0
2,2,0.5,0.5,true,true,850,200,898,798,48,598,2,true,true,true,-1.0
2,2,0.5,0.5,true,true,200,300,797,897,597,597,3,true,true,true,-1.0
2,2,0.5,0.5,true,true,200,250,200,250,0,0,0,true,true,true,-1.0
2,2,0.5,0.5,true,false,300,900,299,899,-1,-1,1,true,true,true,399.502
2,2,0.5,0.5,true,false,350,250,897,297,547,47,3,true,true,true,-1.0
2,2,0.5,0.5,true,false,200,200,200,200,0,0,0,true,true,true,-1.0
2,2,0.5,0.5,true,false,250,350,798,398,548,48,2,true,true,true,-1.0
2,2,0.5,0.5,true,false,250,250,299,299,49,49,1,true,true,true,-1.0
2,2,0.5,0.5,true,false,250,250,796,946,546,696,4,true,true,true,-1.0
2,2,0.5,0.5,true,false,250,300,298,898,48,598,2,true,true,true,-1.0
2,2,0.5,0.5,true,false,300,300,300,300,0,0,0,true,true,true,-1.0
2,2,0.5,0.5,true,false,200,250,198,248,-2,-2,2,true,true,true,-1.0
2,2,0.5,0.5,true,false,250,900,248,898,-2,-2,2,true,true,true,-1.0
2,2,0.5,0.5,true,false,350,300,899,849,549,549,1,true,true,true,-1.0
2,2,0.5,0.5,true,false,250,250,249,249,-1,-1,1,true,true,true,-1.0
2,2,0.5,0.5,true,false,250,350,299,399,49,49,1,true,true,true,-1.0
2,2,0.5,0.5,true,false,900,250,900,250,0,0,0,true,true,true,-1.0
2,2,0.5,0.5,true,false,850,300,850,300,0,0,0,true,true,true,-1.0
2,2,0.5,0.5,true,false,300,250,299,249,-1,-1,1,true,true,true,-1.0
2,2,0.5,0.5,true,false,200,200,799,249,599,49,1,true,true,true,-1.0
2,2,0.5,0.5,true,false,250,250,298,848,48,598,2,true,true,true,-1.0
2,2,0.5,0.5,true,false,250,200,299,249,49,49,1,true,true,true,-1.0
2,2,0.5,0.5,true,false,200,900,198,898,-2,-2,2,true,true,true,-1.0
2,2,0.5,0.5,false,true,250,250,248,248,-2,-2,2,true,true,true,262.408
2,2,0.5,0.5,false,true,200,200,200,200,0,0,0,true,true,true,-1.0
2,2,0.5,0.5,false,true,200,300,348,848,148,548,2,true,true,true,-1.0
2,2,0.5,0.5,false,true,300,300,899,799,599,499,1,true,true,true,-1.0
2,2,0.5,0.5,false,true,300,250,299,249,-1,-1,1,true,true,true,-1.0
2,2,0.5,0.5,false,true,850,300,850,300,0,0,0,true,true,true,-1.0
2,2,0.5,0.5,false,true,850,850,849,849,-1,-1,1,true,true,true,-1.0
2,2,0.5,0.5,false,true,250,250,250,250,0,0,0,true,true,true,-1.0
2,2,0.5,0.5,false,true,300,350,799,399,499,49,1,true,true,true,-1.0
2,2,0.5,0.5,false,true,250,250,798,348,548,98,2,true,true,true,-1.0
2,2,0.5,0.5,false,true,250,850,249,849,-1,-1,1,true,true,true,-1.0
2,2,0.5,0.5,false,true,250,200,250,200,0,0,0,true,true,true,-1.0
2,2,0.5,0.5,false,true,200,250,347,847,147,597,3,true,false,true,-1.0
2,2,0.5,0.5,false,true,200,300,895,845,695,545,5,true,true,true,-1.0
2,2,0.5,0.5,false,true,300,200,299,199,-1,-1,1,true,true,true,-1.0
2,2,0.5,0.5,false,true,300,250,298,248,-2,-2,2,true,true,true,-1.0
2,2,0.5,0.5,false,true,350,250,899,349,549,99,1,true,true,true,-1.0
2,2,0.5,0.5,false,true,250,250,298,898,48,648,2,true,true,true,-1.0
2,2,0.5,0.5,false,true,300,300,798,348,498,48,2,true,true,true,-1.0
2,2,0.5,0.5,false,true,850,250,850,250,0,0,0,true,true,true,-1.0
2,2,0.5,0.5,false,false,250,200,299,799,49,599,1,true,true,true,145.918
2,2,0.5,0.5,false,false,300,300,298,298,-2,-2,2,true,true,true,-1.0
2,2,0.5,0.5,false,false,200,850,199,849,-1,-1,1,true,true,true,-1.0
2,2,0.5,0.5,false,false,200,200,200,200,0,0,0,true,true,true,-1.0
2,2,0.5,0.5,false,false,300,200,799,249,499,49,1,true,true,true,-1.0
2,2,0.5,0.5,false,false,300,300,848,848,548,548,2,true,true,true,-1.0
2,2,0.5,0.5,false,false,850,250,898,798,48,548,2,true,true,true,-1.0
2,2,0.5,0.5,false,false,300,200,296,196,-4,-4,4,true,true,true,-1.0
2,2,0.5,0.5,false,false,250,250,248,248,-2,-2,2,true,true,true,-1.0
2,2,0.5,0.5,false,false,850,250,850,250,0,0,0,true,true,true,-1.0
2,2,0.5,0.5,false,false,350,250,898,298,548,48,2,true,true,true,-1.0
2,2,0.5,0.5,false,false,250,850,249,849,-1,-1,1,true,true,true,-1.0
2,2,0.5,0.5,false,false,300,300,898,798,598,498,2,true,true,true,-1.0
2,2,0.5,0.5,false,false,350,300,898,848,548,548,2,true,true,true,-1.0
2,2,0.5,0.5,false,false,300,200,300,200,0,0,0,true,true,true,-1.0
2,2,0.5,0.5,false,false,250,250,250,250,0,0,0,true,true,true,-1.0
2,2,0.5,0.5,false,false,850,250,850,250,0,0,0,true,true,true,-1.0
2,2,0.5,0.5,false,false,350,250,349,249,-1,-1,1,true,true,true,-1.0
2,2,0.5,0.5,false,false,250,250,250,250,0,0,0,true,true,true,-1.0
2,2,0.5,0.5,false,false,200,250,248,898,48,648,2,true,true,true,-1.0
0,0,0.5,0.5,false,false,300,200,297,197,-3,-3,3,true,true,true,0.182
0,0,0.5,0.5,false,false,300,850,799,899,499,49,1,true,true,true,-1.0
0,0,0.5,0.5,false,false,850,250,847,247,-3,-3,3,true,true,true,-1.0
0,0,0.5,0.5,false,false,250,850,247,847,-3,-3,3,true,true,true,-1.0
0,0,0.5,0.5,false,false,250,250,248,248,-2,-2,2,true,true,true,-1.0
0,0,0.5,0.5,false,false,250,200,247,197,-3,-3,3,true,true,true,-1.0
0,0,0.5,0.5,false,false,250,300,298,798,48,498,2,true,true,true,-1.0
0,0,0.5,0.5,false,false,850,300,848,298,-2,-2,2,true,true,true,-1.0
0,0,0.5,0.5,false,false,200,200,197,197,-3,-3,3,true,true,true,-1.0
0,0,0.5,0.5,false,false,300,300,298,298,-2,-2,2,true,true,true,-1.0
0,0,0.5,0.5,false,false,250,300,298,898,48,598,2,true,true,true,-1.0
0,0,0.5,0.5,false,false,250,350,298,948,48,598,2,true,true,true,-1.0
0,0,0.5,0.5,false,false,300,350,296,346,-4,-4,4,true,true,true,-1.0
0,0,0.5,0.5,false,false,300,250,797,897,497,647,3,true,true,true,-1.0
0,0,0.5,0.5,false,false,250,250,247,247,-3,-3,3,false,false,false,-1.0
0,0,0.5,0.5,false,false,200,850,247,897,47,47,3,true,true,true,-1.0
0,0,0.5,0.5,false,false,250,250,248,248,-2,-2,2,true,true,true,-1.0
0,0,0.5,0.5,false,false,300,850,298,848,-2,-2,2,true,true,true,-1.0
0,0,0.5,0.5,false,false,300,300,298,298,-2,-2,2,true,true,true,-1.0
0,0,0.5,0.5,false,false,350,350,346,346,-4,-4,4,true,true,true,-1.0
0,1,0.5,0.5,false,false,300,300,348,798,48,498,2,true,true,true,0.268
0,1,0.5,0.5,false,false,200,200,248,248,48,48,2,true,true,true,-1.0
0,1,0.5,0.5,false,false,850,300,898,798,48,498,2,true,true,true,-1.0
0,1,0.5,0.5,false,false,200,300,248,798,48,498,2,true,true,true,-1.0
0,1,0.5,0.5,false,false,250,250,246,246,-4,-4,4,true,true,true,-1.0
0,1,0.5,0.5,false,false,300,200,348,798,48,598,2,true,true,true,-1.0
0,1,0.5,0.5,false,false,850,850,846,846,-4,-4,4,true,true,true,-1.0
0,1,0.5,0.5,false,false,250,200,246,196,-4,-4,4,true,true,true,-1.0
0,1,0.5,0.5,false,false,850,200,846,196,-4,-4,4,true,true,true,-1.0
0,1,0.5,0.5,false,false,900,250,896,246,-4,-4,4,true,true,true,-1.0
0,1,0.5,0.5,false,false,250,300,298,848,48,548,2,false,false,true,-1.0
0,1,0.5,0.5,false,false,350,850,346,846,-4,-4,4,true,true,true,-1.0
0,1,0.5,0.5,false,false,250,200,246,196,-4,-4,4,true,true,true,-1.0
0,1,0.5,0.5,false,false,850,850,846,846,-4,-4,4,true,true,true,-1.0
0,1,0.5,0.5,false,false,300,200,296,196,-4,-4,4,false,false,false,-1.0
0,1,0.5,0.5,false,false,250,300,348,798,98,498,2,true,true,true,-1.0
0,1,0.5,0.5,false,false,300,300,348,798,48,498,2,true,true,true,-1.0
0,1,0.5,0.5,false,false,300,200,298,198,-2,-2,2,true,true,true,-1.0
0,1,0.5,0.5,false,false,250,350,247,347,-3,-3,3,true,true,true,-1.0
0,1,0.5,0.5,false,false,300,850,297,847,-3,-3,3,true,true,true,-1.0
0,2,0.5,0.5,false,true,850,250,849,249,-1,-1,1,true,true,true,377.127
0,2,0.5,0.5,false,true,350,200,346,196,-4,-4,4,true,true,true,-1.0
0,2,0.5,0.5,false,true,250,200,797,247,547,47,3,true,true,true,-1.0
0,2,0.5,0.5,false,true,850,850,849,849,-1,-1,1,true,true,true,-1.0
0,2,0.5,0.5,false,true,250,300,246,296,-4,-4,4,false,false,false,-1.0
0,2,0.5,0.5,false,true,200,200,196,196,-4,-4,4,true,true,true,-1.0
0,2,0.5,0.5,false,true,200,200,248,298,48,98,2,true,false,true,-1.0
0,2,0.5,0.5,false,true,300,250,348,798,48,548,2,true,true,true,-1.0
0,2,0.5,0.5,false,true,350,250,346,246,-4,-4,4,false,false,false,-1.0
0,2,0.5,0.5,false,true,200,300,248,898,48,598,2,true,true,true,-1.0
0,2,0.5,0.5,false,true,300,200,346,246,46,46,4,true,true,true,-1.0
0,2,0.5,0.5,false,true,350,300,346,296,-4,-4,4,true,true,true,-1.0
0,2,0.5,0.5,false,true,850,300,898,798,48,498,2,true,true,true,-1.0
0,2,0.5,0.5,false,true,250,250,246,246,-4,-4,4,true,true,true,-1.0
0,2,0.5,0.5,false,true,250,300,246,296,-4,-4,4,true,true,true,-1.0
0,2,0.5,0.5,false,true,300,200,296,196,-4,-4,4,false,false,false,-1.0
0,2,0.5,0.5,false,true,250,250,249,249,-1,-1,1,true,true,true,-1.0
0,2,0.5,0.5,false,true,300,200,347,297,47,97,3,true,true,true,-1.0
0,2,0.5,0.5,false,true,850,350,846,346,-4,-4,4,true,true,true,-1.0
0,2,0.5,0.5,false,true,300,300,348,798,48,498,2,true,true,true,-1.0
0,2,0.5,0.5,false,false,300,850,296,846,-4,-4,4,true,true,true,70.037
0,2,0.5,0.5,false,false,300,300,296,296,-4,-4,4,false,false,false,-1.0
0,2,0.5,0.5,false,false,200,350,197,347,-3,-3,3,true,true,true,-1.0
0,2,0.5,0.5,false,false,300,200,348,798,48,598,2,true,true,true,-1.0
0,2,0.5,0.5,false,false,350,250,346,246,-4,-4,4,true,true,true,-1.0
0,2,0.5,0.5,false,false,250,900,249,899,-1,-1,1,true,true,true,-1.0
0,2,0.5,0.5,false,false,200,200,348,848,148,648,2,true,true,true,-1.0
0,2,0.5,0.5,false,false,300,250,296,246,-4,-4,4,true,true,true,-1.0
0,2,0.5,0.5,false,false,300,850,299,849,-1,-1,1,true,true,true,-1.0
0,2,0.5,0.5,false,false,850,200,848,198,-2,-2,2,true,true,true,-1.0
0,2,0.5,0.5,false,false,300,200,296,196,-4,-4,4,true,true,true,-1.0
0,2,0.5,0.5,false,false,200,900,199,899,-1,-1,1,true,true,true,-1.0
0,2,0.5,0.5,false,false,350,250,346,246,-4,-4,4,true,true,true,-1.0
0,2,0.5,0.5,false,false,200,250,346,796,146,546,4,true,true,true,-1.0
0,2,0.5,0.5,false,false,300,300,799,899,499,599,1,true,true,true,-1.0
0,2,0.5,0.5,false,false,350,250,398,298,48,48,2,true,false,true,-1.0
0,2,0.5,0.5,false,false,300,300,298,298,-2,-2,2,true,true,true,-1.0
0,2,0.5,0.5,false,false,850,200,846,196,-4,-4,4,true,true,true,-1.0
0,2,0.5,0.5,false,false,250,200,298,298,48,98,2,true,true,true,-1.0
0,2,0.5,0.5,false,false,350,250,346,246,-4,-4,4,true,true,true,-1.0
1,0,0.5,0.5,false,false,850,300,845,295,-5,-5,5,true,true,true,0.376
1,0,0.5,0.5,false,false,300,200,297,197,-3,-3,3,true,true,true,-1.0
1,0,0.5,0.5,false,false,350,350,345,345,-5,-5,5,true,true,true,-1.0
1,0,0.5,0.5,false,false,350,300,399,799,49,499,1,true,true,true,-1.0
1,0,0.5,0.5,false,false,900,300,896,296,-4,-4,4,true,true,true,-1.0
1,0,0.5,0.5,false,false,300,250,300,250,0,0,0,true,true,true,-1.0
1,0,0.5,0.5,false,false,200,850,299,899,99,49,1,true,true,true,-1.0
1,0,0.5,0.5,false,false,250,850,247,847,-3,-3,3,true,true,true,-1.0
1,0,0.5,0.5,false,false,300,300,300,300,0,0,0,true,true,true,-1.0
1,0,0.5,0.5,false,false,250,350,247,347,-3,-3,3,true,true,true,-1.0
1,0,0.5,0.5,false,false,200,250,798,348,598,98,2,true,true,true,-1.0
1,0,0.5,0.5,false,false,250,350,247,347,-3,-3,3,true,true,true,-1.0
1,0,0.5,0.5,false,false,300,850,297,847,-3,-3,3,false,false,false,-1.0
1,0,0.5,0.5,false,false,850,200,897,247,47,47,3,true,false,true,-1.0
1,0,0.5,0.5,false,false,900,300,900,300,0,0,0,true,true,true,-1.0
1,0,0.5,0.5,false,false,300,200,300,200,0,0,0,false,false,false,-1.0
1,0,0.5,0.5,false,false,300,250,300,250,0,0,0,true,true,true,-1.0
1,0,0.5,0.5,false,false,850,250,850,250,0,0,0,true,true,true,-1.0
1,0,0.5,0.5,false,false,850,350,845,345,-5,-5,5,true,true,true,-1.0
1,0,0.5,0.5,false,false,200,200,299,799,99,599,1,true,true,true,-1.0
1,1,0.5,0.5,false,false,900,200,900,200,0,0,0,true,true,true,1.407
1,1,0.5,0.5,false,false,300,200,348,298,48,98,2,true,true,true,-1.0
1,1,0.5,0.5,false,false,300,300,250,250,-50,-50,50,true,true,true,-1.0
1,1,0.5,0.5,false,false,350,300,300,250,-50,-50,50,true,true,true,-1.0
1,1,0.5,0.5,false,false,300,300,250,250,-50,-50,50,true,true,true,-1.0
1,1,0.5,0.5,false,false,850,300,899,799,49,499,1,true,true,true,-1.0
1,1,0.5,0.5,false,false,250,250,799,949,549,699,1,true,true,true,-1.0
1,1,0.5,0.5,false,false,250,300,299,349,49,49,1,true,true,true,-1.0
1,1,0.5,0.5,false,false,250,300,247,297,-3,-3,3,true,true,true,-1.0
1,1,0.5,0.5,false,false,300,300,250,250,-50,-50,50,true,true,true,-1.0
1,1,0.5,0.5,false,false,900,200,948,798,48,598,2,true,true,true,-1.0
1,1,0.5,0.5,false,false,300,350,250,300,-50,-50,50,true,true,true,-1.0
1,1,0.5,0.5,false,false,300,250,250,200,-50,-50,50,false,false,false,-1.0
1,1,0.5,0.5,false,false,300,850,300,850,0,0,0,true,true,true,-1.0
1,1,0.5,0.5,false,false,250,350,799,949,549,599,1,true,true,true,-1.0
1,1,0.5,0.5,false,false,200,200,150,150,-50,-50,50,false,false,false,-1.0
1,1,0.5,0.5,false,false,900,300,949,799,49,499,1,true,true,true,-1.0
1,1,0.5,0.5,false,false,250,850,247,847,-3,-3,3,true,true,true,-1.0
1,1,0.5,0.5,false,false,300,200,898,798,598,598,2,true,true,true,-1.0
1,1,0.5,0.5,false,false,900,250,900,250,0,0,0,true,true,true,-1.0
1,2,0.5,0.5,false,true,350,300,350,300,0,0,0,true,true,true,376.56
1,2,0.5,0.5,false,true,250,200,250,200,0,0,0,false,false,false,-1.0
1,2,0.5,0.5,false,true,300,300,298,298,-2,-2,2,true,true,true,-1.0
1,2,0.5,0.5,false,true,300,850,300,850,0,0,0,true,true,true,-1.0
1,2,0.5,0.5,false,true,250,900,248,898,-2,-2,2,true,true,true,-1.0
1,2,0.5,0.5,false,true,300,850,300,850,0,0,0,true,true,true,-1.0
1,2,0.5,0.5,false,true,250,350,248,348,-2,-2,2,true,true,true,-1.0
1,2,0.5,0.5,false,true,250,250,298,848,48,598,2,true,true,true,-1.0
1,2,0.5,0.5,false,true,900,900,898,898,-2,-2,2,true,true,true,-1.0
1,2,0.5,0.5,false,true,250,200,250,200,0,0,0,true,true,true,-1.0
1,2,0.5,0.5,false,true,850,200,850,200,0,0,0,true,true,true,-1.0
1,2,0.5,0.5,false,true,250,350,799,399,549,49,1,true,true,true,-1.0
1,2,0.5,0.5,false,true,250,300,298,798,48,498,2,true,true,true,-1.0
1,2,0.5,0.5,false,true,850,300,850,300,0,0,0,true,true,true,-1.0
1,2,0.5,0.5,false,true,300,350,298,348,-2,-2,2,true,true,true,-1.0
1,2,0.5,0.5,false,true,850,850,850,850,0,0,0,true,true,true,-1.0
1,2,0.5,0.5,false,true,250,300,246,296,-4,-4,4,true,true,true,-1.0
1,2,0.5,0.5,false,true,300,250,345,295,45,45,5,true,true,true,-1.0
1,2,0.5,0.5,false,true,300,350,797,947,497,597,3,true,true,true,-1.0
1,2,0.5,0.5,false,true,350,350,348,348,-2,-2,2,true,true,true,-1.0
1,2,0.5,0.5,false,false,200,200,298,798,98,598,2,true,true,true,113.419
1,2,0.5,0.5,false,false,200,300,247,347,47,47,3,true,true,true,-1.0
1,2,0.5,0.5,false,false,300,300,797,347,497,47,3,true,true,true,-1.0
1,2,0.5,0.5,false,false,300,850,298,848,-2,-2,2,true,true,true,-1.0
1,2,0.5,0.5,false,false,200,900,248,948,48,48,2,true,true,true,-1.0
1,2,0.5,0.5,false,false,300,300,296,296,-4,-4,4,true,true,true,-1.0
1,2,0.5,0.5,false,false,200,300,199,299,-1,-1,1,true,true,true,-1.0
1,2,0.5,0.5,false,false,300,300,298,298,-2,-2,2,true,true,true,-1.0
1,2,0.5,0.5,false,false,300,300,349,799,49,499,1,true,true,true,-1.0
1,2,0.5,0.5,false,false,250,200,250,200,0,0,0,true,true,true,-1.0
1,2,0.5,0.5,false,false,250,200,799,299,549,99,1,true,true,true,-1.0
1,2,0.5,0.5,false,false,300,250,797,297,497,47,3,true,true,true,-1.0
1,2,0.5,0.5,false,false,350,200,350,200,0,0,0,true,true,true,-1.0
1,2,0.5,0.5,false,false,300,850,298,848,-2,-2,2,true,true,true,-1.0
1,2,0.5,0.5,false,false,200,200,200,200,0,0,0,true,true,true,-1.0
1,2,0.5,0.5,false,false,200,850,198,848,-2,-2,2,true,true,true,-1.0
1,2,0.5,0.5,false,false,300,300,898,798,598,498,2,true,true,true,-1.0
1,2,0.5,0.5,false,false,300,200,252,152,-48,-48,48,true,true,true,-1.0
1,2,0.5,0.5,false,false,250,300,849,849,599,549,1,true,true,true,-1.0
1,2,0.5,0.5,false,false,200,250,198,248,-2,-2,2,true,true,true,-1.0
2,0,0.5,0.5,true,false,200,200,299,249,99,49,1,true,true,true,642.774
2,0,0.5,0.5,true,false,250,350,798,948,548,598,2,true,true,true,-1.0
2,0,0.5,0.5,true,false,850,300,850,300,0,0,0,true,true,true,-1.0
2,0,0.5,0.5,true,false,250,200,247,197,-3,-3,3,true,true,true,-1.0
2,0,0.5,0.5,true,false,350,300,350,300,0,0,0,true,true,true,-1.0
2,0,0.5,0.5,true,false,350,250,899,849,549,599,1,true,true,true,-1.0
2,0,0.5,0.5,true,false,300,250,295,245,-5,-5,5,true,true,true,-1.0
2,0,0.5,0.5,true,false,300,300,295,295,-5,-5,5,false,false,false,-1.0
2,0,0.5,0.5,true,false,300,300,797,897,497,597,3,true,true,true,-1.0
2,0,0.5,0.5,true,false,850,250,847,247,-3,-3,3,true,true,true,-1.0
2,0,0.5,0.5,true,false,300,250,898,798,598,548,2,true,true,true,-1.0
2,0,0.5,0.5,true,false,250,250,247,247,-3,-3,3,true,true,true,-1.0
2,0,0.5,0.5,true,false,200,300,249,799,49,499,1,true,true,true,-1.0
2,0,0.5,0.5,true,false,300,250,298,248,-2,-2,2,true,true,true,-1.0
2,0,0.5,0.5,true,false,300,250,300,250,0,0,0,true,true,true,-1.0
2,0,0.5,0.5,true,false,300,300,295,295,-5,-5,5,true,true,true,-1.0
2,0,0.5,0.5,true,false,250,250,248,248,-2,-2,2,true,true,true,-1.0
2,0,0.5,0.5,true,false,200,200,195,195,-5,-5,5,true,true,true,-1.0
2,0,0.5,0.5,true,false,200,300,196,296,-4,-4,4,true,true,true,-1.0
2,0,0.5,0.5,true,false,850,900,847,897,-3,-3,3,true,true,true,-1.0
2,0,0.5,0.5,false,false,300,200,297,197,-3,-3,3,true,true,true,93.206
2,0,0.5,0.5,false,false,850,200,899,799,49,599,1,true,true,true,-1.0
2,0,0.5,0.5,false,false,200,300,197,297,-3,-3,3,true,true,true,-1.0
2,0,0.5,0.5,false,false,850,200,850,200,0,0,0,true,true,true,-1.0
2,0,0.5,0.5,false,false,300,200,797,247,497,47,3,true,true,true,-1.0
2,0,0.5,0.5,false,false,250,250,247,247,-3,-3,3,true,true,true,-1.0
2,0,0.5,0.5,false,false,300,350,296,346,-4,-4,4,true,true,true,-1.0
2,0,0.5,0.5,false,false,200,250,197,247,-3,-3,3,false,false,false,-1.0
2,0,0.5,0.5,false,false,250,200,797,947,547,747,3,true,true,true,-1.0
2,0,0.5,0.5,false,false,250,900,247,897,-3,-3,3,true,true,true,-1.0
2,0,0.5,0.5,false,false,300,200,848,898,548,698,2,true,true,true,-1.0
2,0,0.5,0.5,false,false,300,250,797,297,497,47,3,true,true,true,-1.0
2,0,0.5,0.5,false,false,850,200,850,200,0,0,0,true,true,true,-1.0
2,0,0.5,0.5,false,false,300,300,297,297,-3,-3,3,true,true,true,-1.0
2,0,0.5,0.5,false,false,200,200,200,200,0,0,0,true,true,true,-1.0
2,0,0.5,0.5,false,false,850,300,845,295,-5,-5,5,true,true,true,-1.0
2,0,0.5,0.5,false,false,300,850,297,847,-3,-3,3,true,true,true,-1.0
2,0,0.5,0.5,false,false,200,300,200,300,0,0,0,true,true,true,-1.0
2,0,0.5,0.5,false,false,850,200,850,200,0,0,0,true,true,true,-1.0
2,0,0.5,0.5,false,false,250,350,245,345,-5,-5,5,true,true,true,-1.0
2,1,0.5,0.5,true,false,250,300,799,349,549,49,1,true,true,true,926.028
2,1,0.5,0.5,true,false,200,300,296,846,96,546,4,true,true,true,-1.0
2,1,0.5,0.5,true,false,850,200,850,200,0,0,0,true,true,true,-1.0
2,1,0.5,0.5,true,false,850,200,899,249,49,49,1,true,false,true,-1.0
2,1,0.5,0.5,true,false,300,300,398,798,98,498,2,true,true,true,-1.0
2,1,0.5,0.5,true,false,250,300,200,250,-50,-50,50,false,false,false,-1.0
2,1,0.5,0.5,true,false,300,850,297,847,-3,-3,3,true,true,true,-1.0
2,1,0.5,0.5,true,false,850,200,899,249,49,49,1,true,true,true,-1.0
2,1,0.5,0.5,true,false,200,250,899,849,699,599,1,true,true,true,-1.0
2,1,0.5,0.5,true,false,350,300,948,798,598,498,2,true,true,true,-1.0
2,1,0.5,0.5,true,false,250,300,247,297,-3,-3,3,false,false,false,-1.0
2,1,0.5,0.5,true,false,250,250,299,299,49,49,1,true,true,true,-1.0
2,1,0.5,0.5,true,false,300,300,297,297,-3,-3,3,true,true,true,-1.0
2,1,0.5,0.5,true,false,850,850,847,847,-3,-3,3,true,true,true,-1.0
2,1,0.5,0.5,true,false,300,250,297,247,-3,-3,3,true,true,true,-1.0
2,1,0.5,0.5,true,false,250,250,798,948,548,698,2,true,true,true,-1.0
2,1,0.5,0.5,true,false,200,200,197,197,-3,-3,3,true,true,true,-1.0
2,1,0.5,0.5,true,false,200,850,191,841,-9,-9,9,true,true,true,-1.0
2,1,0.5,0.5,true,false,850,350,847,347,-3,-3,3,true,true,true,-1.0
2,1,0.5,0.5,true,false,250,300,298,798,48,498,2,true,true,true,-1.0
2,1,0.5,0.5,false,false,200,850,197,847,-3,-3,3,true,true,true,113.905
2,1,0.5,0.5,false,false,850,300,847,297,-3,-3,3,true,true,true,-1.0
2,1,0.5,0.5,false,false,300,250,897,847,597,597,3,true,true,true,-1.0
2,1,0.5,0.5,false,false,850,300,850,300,0,0,0,true,true,true,-1.0
2,1,0.5,0.5,false,false,200,250,150,200,-50,-50,50,false,false,false,-1.0
2,1,0.5,0.5,false,false,300,300,798,348,498,48,2,true,true,true,-1.0
2,1,0.5,0.5,false,false,250,250,797,297,547,47,3,true,true,true,-1.0
2,1,0.5,0.5,false,false,300,350,297,347,-3,-3,3,true,true,true,-1.0
2,1,0.5,0.5,false,false,850,350,847,347,-3,-3,3,true,true,true,-1.0
2,1,0.5,0.5,false,false,350,850,347,847,-3,-3,3,true,true,true,-1.0
2,1,0.5,0.5,false,false,200,200,197,197,-3,-3,3,true,true,true,-1.0
2,1,0.5,0.5,false,false,250,200,348,798,98,598,2,true,true,true,-1.0
2,1,0.5,0.5,false,false,200,300,191,291,-9,-9,9,true,true,true,-1.0
2,1,0.5,0.5,false,false,300,300,797,897,497,597,3,true,true,true,-1.0
2,1,0.5,0.5,false,false,850,300,899,799,49,499,1,true,true,true,-1.0
2,1,0.5,0.5,false,false,850,900,849,899,-1,-1,1,true,true,true,-1.0
2,1,0.5,0.5,false,false,200,300,798,948,598,648,2,true,true,true,-1.0
2,1,0.5,0.5,false,false,200,250,230,780,30,530,20,true,true,true,-1.0
2,1,0.5,0.5,false,false,300,300,799,349,499,49,1,true,true,true,-1.0
2,1,0.5,0.5,false,false,850,250,847,247,-3,-3,3,true,true,true,-1.0
2,2,0.5,0.5,true,true,300,250,300,250,0,0,0,true,true,true,750.293
2,2,0.5,0.5,true,true,300,250,300,250,0,0,0,true,true,true,-1.0
2,2,0.5,0.5,true,true,350,300,348,298,-2,-2,2,true,true,true,-1.0
2,2,0.5,0.5,true,true,300,200,799,899,499,699,1,true,true,true,-1.0
2,2,0.5,0.5,true,true,850,200,849,199,-1,-1,1,true,true,true,-1.0
2,2,0.5,0.5,true,true,200,850,199,849,-1,-1,1,true,true,true,-1.0
2,2,0.5,0.5,true,true,300,250,898,798,598,548,2,true,true,true,-1.0
2,2,0.5,0.5,true,true,300,250,348,798,48,548,2,true,false,true,-1.0
2,2,0.5,0.5,true,true,250,250,299,299,49,49,1,true,true,true,-1.0
2,2,0.5,0.5,true,true,250,200,250,200,0,0,0,true,true,true,-1.0
2,2,0.5,0.5,true,true,300,350,848,898,548,548,2,true,true,true,-1.0
2,2,0.5,0.5,true,true,350,300,399,799,49,499,1,true,true,true,-1.0
2,2,0.5,0.5,true,true,350,200,899,299,549,99,1,true,true,true,-1.0
2,2,0.5,0.5,true,true,250,300,298,848,48,548,2,true,true,true,-1.0
2,2,0.5,0.5,true,true,300,200,297,197,-3,-3,3,true,true,true,-1.0
2,2,0.5,0.5,true,true,250,300,298,798,48,498,2,true,true,true,-1.0
2,2,0.5,0.5,true,true,350,850,349,849,-1,-1,1,true,true,true,-1.0
2,2,0.5,0.5,true,true,300,250,299,249,-1,-1,1,true,true,true,-1.0
2,2,0.5,0.5,true,true,300,200,298,198,-2,-2,2,true,true,true,-1.0
2,2,0.5,0.5,true,true,300,300,299,299,-1,-1,1,true,true,true,-1.0
2,2,0.5,0.5,true,false,300,250,799,349,499,99,1,true,true,true,378.015
2,2,0.5,0.5,true,false,200,300,299,799,99,499,1,true,true,true,-1.0
2,2,0.5,0.5,true,false,200,200,299,249,99,49,1,true,true,true,-1.0
2,2,0.5,0.5,true,false,200,300,248,798,48,498,2,true,true,true,-1.0
2,2,0.5,0.5,true,false,850,250,850,250,0,0,0,true,true,true,-1.0
2,2,0.5,0.5,true,false,300,200,798,248,498,48,2,true,true,true,-1.0
2,2,0.5,0.5,true,false,200,300,248,798,48,498,2,true,true,true,-1.0
2,2,0.5,0.5,true,false,900,300,899,299,-1,-1,1,true,true,true,-1.0
2,2,0.5,0.5,true,false,850,350,850,350,0,0,0,true,true,true,-1.0
2,2,0.5,0.5,true,false,850,300,850,300,0,0,0,true,true,true,-1.0
2,2,0.5,0.5,true,false,850,300,898,798,48,498,2,true,true,true,-1.0
2,2,0.5,0.5,true,false,850,850,849,849,-1,-1,1,true,true,true,-1.0
2,2,0.5,0.5,true,false,300,300,349,799,49,499,1,true,true,true,-1.0
2,2,0.5,0.5,true,false,250,200,250,200,0,0,0,true,true,true,-1.0
2,2,0.5,0.5,true,false,850,850,849,849,-1,-1,1,true,true,true,-1.0
2,2,0.5,0.5,true,false,850,350,850,350,0,0,0,true,true,true,-1.0
2,2,0.5,0.5,true,false,200,300,248,798,48,498,2,true,true,true,-1.0
2,2,0.5,0.5,true,false,300,250,799,299,499,49,1,true,true,true,-1.0
2,2,0.5,0.5,true,false,250,200,250,200,0,0,0,true,true,true,-1.0
2,2,0.5,0.5,true,false,300,300,299,299,-1,-1,1,true,true,true,-1.0
2,2,0.5,0.5,false,true,250,200,249,199,-1,-1,1,true,true,true,138.518
2,2,0.5,0.5,false,true,300,300,348,798,48,498,2,true,true,true,-1.0
2,2,0.5,0.5,false,true,350,250,398,798,48,548,2,true,true,true,-1.0
2,2,0.5,0.5,false,true,200,200,198,198,-2,-2,2,true,true,true,-1.0
2,2,0.5,0.5,false,true,350,300,350,300,0,0,0,true,true,true,-1.0
2,2,0.5,0.5,false,true,200,300,199,299,-1,-1,1,true,true,true,-1.0
2,2,0.5,0.5,false,true,850,350,850,350,0,0,0,true,true,true,-1.0
2,2,0.5,0.5,false,true,200,850,298,898,98,48,2,true,true,true,-1.0
2,2,0.5,0.5,false,true,350,850,348,848,-2,-2,2,true,true,true,-1.0
2,2,0.5,0.5,false,true,350,300,349,299,-1,-1,1,true,true,true,-1.0
2,2,0.5,0.5,false,true,850,300,850,300,0,0,0,true,true,true,-1.0
2,2,0.5,0.5,false,true,850,350,849,349,-1,-1,1,true,true,true,-1.0
2,2,0.5,0.5,false,true,850,300,849,299,-1,-1,1,true,true,true,-1.0
2,2,0.5,0.5,false,true,300,300,299,299,-1,-1,1,true,true,true,-1.0
2,2,0.5,0.5,false,true,250,350,248,348,-2,-2,2,true,true,true,-1.0
2,2,0.5,0.5,false,true,250,350,250,350,0,0,0,true,true,true,-1.0
2,2,0.5,0.5,false,true,300,300,349,799,49,499,1,true,true,true,-1.0
2,2,0.5,0.5,false,true,250,350,249,349,-1,-1,1,true,true,true,-1.0
2,2,0.5,0.5,false,true,250,300,248,298,-2,-2,2,true,true,true,-1.0
2,2,0.5,0.5,false,true,200,250,150,200,-50,-50,50,false,false,false,-1.0
2,2,0.5,0.5,false,false,850,250,899,799,49,549,1,true,true,true,103.805
2,2,0.5,0.5,false,false,900,200,900,200,0,0,0,true,true,true,-1.0
2,2,0.5,0.5,false,false,300,250,293,243,-7,-7,7,true,true,true,-1.0
2,2,0.5,0.5,false,false,350,250,899,299,549,49,1,true,true,true,-1.0
2,2,0.5,0.5,false,false,200,300,299,349,99,49,1,true,true,true,-1.0
2,2,0.5,0.5,false,false,250,200,799,299,549,99,1,true,true,true,-1.0
2,2,0.5,0.5,false,false,300,250,299,249,-1,-1,1,true,true,true,-1.0
2,2,0.5,0.5,false,false,300,300,299,299,-1,-1,1,true,true,true,-1.0
2,2,0.5,0.5,false,false,350,200,346,196,-4,-4,4,true,true,true,-1.0
2,2,0.5,0.5,false,false,200,250,199,249,-1,-1,1,true,true,true,-1.0
2,2,0.5,0.5,false,false,350,850,350,850,0,0,0,true,true,true,-1.0
2,2,0.5,0.5,false,false,250,300,248,298,-2,-2,2,true,true,true,-1.0
2,2,0.5,0.5,false,false,300,350,799,399,499,49,1,true,true,true,-1.0
2,2,0.5,0.5,false,false,200,900,248,948,48,48,2,true,true,true,-1.0
2,2,0.5,0.5,false,false,250,250,249,249,-1,-1,1,true,true,true,-1.0
2,2,0.5,0.5,false,false,300,300,798,898,498,598,2,true,true,true,-1.0
2,2,0.5,0.5,false,false,850,350,849,349,-1,-1,1,true,true,true,-1.0
2,2,0.5,0.5,false,false,200,250,199,249,-1,-1,1,true,true,true,-1.0
2,2,0.5,0.5,false,false,200,300,248,798,48,498,2,true,true,true,-1.0
2,2,0.5,0.5,false,false,350,250,348,248,-2,-2,2,true,true,true,-1.0
0,0,0.5,0.5,false,false,850,300,898,798,48,498,2,true,true,true,0.249
0,0,0.5,0.5,false,false,250,300,247,297,-3,-3,3,true,true,true,-1.0
0,0,0.5,0.5,false,false,300,300,297,297,-3,-3,3,true,true,true,-1.0
0,0,0.5,0.5,false,false,300,300,296,296,-4,-4,4,true,true,true,-1.0
0,0,0.5,0.5,false,false,350,900,347,897,-3,-3,3,true,true,true,-1.0
0,0,0.5,0.5,false,false,300,850,296,846,-4,-4,4,true,true,true,-1.0
0,0,0.5,0.5,false,false,850,200,848,198,-2,-2,2,true,true,true,-1.0
0,0,0.5,0.5,false,false,200,300,196,296,-4,-4,4,true,true,true,-1.0
0,0,0.5,0.5,false,false,250,200,298,798,48,598,2,true,true,true,-1.0
0,0,0.5,0.5,false,false,200,300,799,899,599,599,1,true,true,true,-1.0
0,0,0.5,0.5,false,false,250,250,297,297,47,47,3,true,true,true,-1.0
0,0,0.5,0.5,false,false,850,850,847,847,-3,-3,3,true,true,true,-1.0
0,0,0.5,0.5,false,false,300,300,849,349,549,49,1,true,true,true,-1.0
0,0,0.5,0.5,false,false,300,250,799,399,499,149,1,true,true,true,-1.0
0,0,0.5,0.5,false,false,250,300,298,798,48,498,2,true,false,true,-1.0
0,0,0.5,0.5,false,false,350,300,947,797,597,497,3,true,true,true,-1.0
0,0,0.5,0.5,false,false,300,850,799,899,499,49,1,true,true,true,-1.0
0,0,0.5,0.5,false,false,850,850,848,848,-2,-2,2,true,true,true,-1.0
0,0,0.5,0.5,false,false,300,250,399,799,99,549,1,true,true,true,-1.0
0,0,0.5,0.5,false,false,850,850,847,847,-3,-3,3,true,true,true,-1.0
0,1,0.5,0.5,false,false,250,200,249,199,-1,-1,1,true,true,true,0.296
0,1,0.5,0.5,false,false,300,300,348,798,48,498,2,true,true,true,-1.0
0,1,0.5,0.5,false,false,850,300,846,296,-4,-4,4,true,true,true,-1.0
0,1,0.5,0.5,false,false,250,300,298,798,48,498,2,true,true,true,-1.0
0,1,0.5,0.5,false,false,900,250,948,798,48,548,2,true,true,true,-1.0
0,1,0.5,0.5,false,false,300,300,296,296,-4,-4,4,true,true,true,-1.0
0,1,0.5,0.5,false,false,250,300,249,299,-1,-1,1,true,true,true,-1.0
0,1,0.5,0.5,false,false,250,200,797,297,547,97,3,true,false,true,-1.0
0,1,0.5,0.5,false,false,350,850,346,846,-4,-4,4,true,true,true,-1.0
0,1,0.5,0.5,false,false,350,250,346,246,-4,-4,4,false,false,false,-1.0
0,1,0.5,0.5,false,false,300,300,898,798,598,498,2,true,true,true,-1.0
0,1,0.5,0.5,false,false,850,300,849,299,-1,-1,1,true,true,true,-1.0
0,1,0.5,0.5,false,false,300,300,348,798,48,498,2,true,true,true,-1.0
0,1,0.5,0.5,false,false,200,250,198,248,-2,-2,2,true,true,true,-1.0
0,1,0.5,0.5,false,false,850,250,846,246,-4,-4,4,true,true,true,-1.0
0,1,0.5,0.5,false,false,300,900,296,896,-4,-4,4,true,true,true,-1.0
0,1,0.5,0.5,false,false,850,250,848,248,-2,-2,2,true,true,true,-1.0
0,1,0.5,0.5,false,false,250,200,298,798,48,598,2,true,true,true,-1.0
0,1,0.5,0.5,false,false,200,200,198,198,-2,-2,2,true,true,true,-1.0
0,1,0.5,0.5,false,false,350,200,948,798,598,598,2,true,true,true,-1.0
0,2,0.5,0.5,false,true,350,300,897,847,547,547,3,true,true,true,399.134
0,2,0.5,0.5,false,true,850,300,848,298,-2,-2,2,true,true,true,-1.0
0,2,0.5,0.5,false,true,900,200,896,196,-4,-4,4,false,false,false,-1.0
0,2,0.5,0.5,false,true,850,250,846,246,-4,-4,4,true,true,true,-1.0
0,2,0.5,0.5,false,true,850,300,898,798,48,498,2,true,true,true,-1.0
0,2,0.5,0.5,false,true,850,850,846,846,-4,-4,4,true,true,true,-1.0
0,2,0.5,0.5,false,true,900,300,899,299,-1,-1,1,true,true,true,-1.0
0,2,0.5,0.5,false,true,250,200,798,248,548,48,2,true,true,true,-1.0
0,2,0.5,0.5,false,true,350,200,349,199,-1,-1,1,true,true,true,-1.0
0,2,0.5,0.5,false,true,300,200,348,298,48,98,2,true,true,true,-1.0
0,2,0.5,0.5,false,true,900,200,896,196,-4,-4,4,true,true,true,-1.0
0,2,0.5,0.5,false,true,250,200,799,899,549,699,1,true,true,true,-1.0
0,2,0.5,0.5,false,true,300,250,296,246,-4,-4,4,true,true,true,-1.0
0,2,0.5,0.5,false,true,300,250,296,246,-4,-4,4,true,true,true,-1.0
0,2,0.5,0.5,false,true,850,200,846,196,-4,-4,4,true,true,true,-1.0
0,2,0.5,0.5,false,true,300,250,799,899,499,649,1,true,true,true,-1.0
0,2,0.5,0.5,false,true,300,850,796,896,496,46,4,true,true,true,-1.0
0,2,0.5,0.5,false,true,850,300,846,296,-4,-4,4,true,true,true,-1.0
0,2,0.5,0.5,false,true,300,250,296,246,-4,-4,4,false,false,false,-1.0
0,2,0.5,0.5,false,true,300,300,797,397,497,97,3,true,true,true,-1.0
0,2,0.5,0.5,false,false,250,300,246,296,-4,-4,4,false,false,false,72.022
0,2,0.5,0.5,false,false,300,300,296,296,-4,-4,4,false,false,false,-1.0
0,2,0.5,0.5,false,false,300,300,799,899,499,599,1,true,true,true,-1.0
0,2,0.5,0.5,false,false,350,300,346,296,-4,-4,4,true,true,true,-1.0
0,2,0.5,0.5,false,false,850,300,846,296,-4,-4,4,true,true,true,-1.0
0,2,0.5,0.5,false,false,850,300,849,299,-1,-1,1,true,true,true,-1.0
0,2,0.5,0.5,false,false,200,250,799,299,599,49,1,true,true,true,-1.0
0,2,0.5,0.5,false,false,850,250,846,246,-4,-4,4,true,true,true,-1.0
0,2,0.5,0.5,false,false,300,250,296,246,-4,-4,4,true,true,true,-1.0
0,2,0.5,0.5,false,false,850,900,849,899,-1,-1,1,true,true,true,-1.0
0,2,0.5,0.5,false,false,250,250,298,798,48,548,2,true,true,true,-1.0
0,2,0.5,0.5,false,false,250,300,247,297,-3,-3,3,true,true,true,-1.0
0,2,0.5,0.5,false,false,300,250,897,297,597,47,3,true,true,true,-1.0
0,2,0.5,0.5,false,false,200,300,348,898,148,598,2,true,true,true,-1.0
0,2,0.5,0.5,false,false,200,250,199,249,-1,-1,1,true,true,true,-1.0
0,2,0.5,0.5,false,false,300,200,298,198,-2,-2,2,true,true,true,-1.0
0,2,0.5,0.5,false,false,850,350,846,346,-4,-4,4,true,true,true,-1.0
0,2,0.5,0.5,false,false,200,200,196,196,-4,-4,4,false,false,false,-1.0
0,2,0.5,0.5,false,false,200,300,196,296,-4,-4,4,true,true,true,-1.0
0,2,0.5,0.5,false,false,250,200,246,196,-4,-4,4,true,true,true,-1.0
1,0,0.5,0.5,false,false,850,300,848,298,-2,-2,2,true,true,true,0.347
1,0,0.5,0.5,false,false,300,200,349,299,49,99,1,true,true,true,-1.0
1,0,0.5,0.5,false,false,850,250,899,799,49,549,1,true,true,true,-1.0
1,0,0.5,0.5,false,false,850,350,850,350,0,0,0,true,true,true,-1.0
1,0,0.5,0.5,false,false,850,850,847,847,-3,-3,3,true,true,true,-1.0
1,0,0.5,0.5,false,false,250,200,847,247,597,47,3,true,true,true,-1.0
1,0,0.5,0.5,false,false,250,850,797,897,547,47,3,true,true,true,-1.0
1,0,0.5,0.5,false,false,250,250,297,297,47,47,3,true,true,true,-1.0
1,0,0.5,0.5,false,false,350,250,347,797,-3,547,3,true,true,true,-1.0
1,0,0.5,0.5,false,false,250,850,247,847,-3,-3,3,true,true,true,-1.0
1,0,0.5,0.5,false,false,300,200,300,200,0,0,0,true,true,true,-1.0
1,0,0.5,0.5,false,false,250,200,246,196,-4,-4,4,true,true,true,-1.0
1,0,0.5,0.5,false,false,200,300,848,898,648,598,2,true,true,true,-1.0
1,0,0.5,0.5,false,false,850,300,850,300,0,0,0,true,true,true,-1.0
1,0,0.5,0.5,false,false,250,300,299,799,49,499,1,true,true,true,-1.0
1,0,0.5,0.5,false,false,250,850,247,847,-3,-3,3,true,true,true,-1.0
1,0,0.5,0.5,false,false,300,250,797,297,497,47,3,false,false,true,-1.0
1,0,0.5,0.5,false,false,850,250,847,247,-3,-3,3,true,true,true,-1.0
1,0,0.5,0.5,false,false,300,350,797,397,497,47,3,true,true,true,-1.0
1,0,0.5,0.5,false,false,350,200,397,297,47,97,3,true,true,true,-1.0
1,1,0.5,0.5,false,false,250,250,248,248,-2,-2,2,true,true,true,1.864
1,1,0.5,0.5,false,false,300,300,250,250,-50,-50,50,false,false,false,-1.0
1,1,0.5,0.5,false,false,250,300,247,297,-3,-3,3,true,true,true,-1.0
1,1,0.5,0.5,false,false,300,200,345,295,45,95,5,true,true,true,-1.0
1,1,0.5,0.5,false,false,300,250,300,250,0,0,0,true,true,true,-1.0
1,1,0.5,0.5,false,false,200,300,199,299,-1,-1,1,true,true,true,-1.0
1,1,0.5,0.5,false,false,250,200,298,798,48,598,2,true,true,true,-1.0
1,1,0.5,0.5,false,false,300,300,849,849,549,549,1,true,true,true,-1.0
1,1,0.5,0.5,false,false,900,250,850,200,-50,-50,50,true,true,true,-1.0
1,1,0.5,0.5,false,false,850,850,800,800,-50,-50,50,true,true,true,-1.0
1,1,0.5,0.5,false,false,200,350,150,300,-50,-50,50,false,false,false,-1.0
1,1,0.5,0.5,false,false,350,250,399,799,49,549,1,true,true,true,-1.0
1,1,0.5,0.5,false,false,850,200,897,247,47,47,3,true,true,true,-1.0
1,1,0.5,0.5,false,false,850,300,800,250,-50,-50,50,true,true,true,-1.0
1,1,0.5,0.5,false,false,250,250,298,798,48,548,2,true,true,true,-1.0
1,1,0.5,0.5,false,false,250,250,246,246,-4,-4,4,true,true,true,-1.0
1,1,0.5,0.5,false,false,250,250,200,200,-50,-50,50,true,true,true,-1.0
1,1,0.5,0.5,false,false,300,300,948,798,648,498,2,true,true,true,-1.0
1,1,0.5,0.5,false,false,850,250,899,799,49,549,1,true,true,true,-1.0
1,1,0.5,0.5,false,false,200,200,150,150,-50,-50,50,true,true,true,-1.0
1,2,0.5,0.5,false,true,350,200,300,150,-50,-50,50,false,false,false,580.967
1,2,0.5,0.5,false,true,300,300,348,348,48,48,2,true,true,true,-1.0
1,2,0.5,0.5,false,true,200,200,798,348,598,148,2,true,true,true,-1.0
1,2,0.5,0.5,false,true,850,850,850,850,0,0,0,true,true,true,-1.0
1,2,0.5,0.5,false,true,300,350,348,898,48,548,2,true,true,true,-1.0
1,2,0.5,0.5,false,true,300,200,250,150,-50,-50,50,false,false,false,-1.0
1,2,0.5,0.5,false,true,850,200,849,199,-1,-1,1,true,true,true,-1.0
1,2,0.5,0.5,false,true,300,350,297,347,-3,-3,3,true,true,true,-1.0
1,2,0.5,0.5,false,true,300,250,797,347,497,97,3,true,false,true,-1.0
1,2,0.5,0.5,false,true,900,200,900,200,0,0,0,true,true,true,-1.0
1,2,0.5,0.5,false,true,200,250,150,200,-50,-50,50,false,false,false,-1.0
1,2,0.5,0.5,false,true,200,250,898,798,698,548,2,true,true,true,-1.0
1,2,0.5,0.5,false,true,300,250,300,250,0,0,0,true,true,true,-1.0
1,2,0.5,0.5,false,true,350,250,350,250,0,0,0,true,true,true,-1.0
1,2,0.5,0.5,false,true,250,900,248,898,-2,-2,2,true,true,true,-1.0
1,2,0.5,0.5,false,true,350,850,348,848,-2,-2,2,true,true,true,-1.0
1,2,0.5,0.5,false,true,250,850,249,849,-1,-1,1,true,true,true,-1.0
1,2,0.5,0.5,false,true,200,850,198,848,-2,-2,2,true,true,true,-1.0
1,2,0.5,0.5,false,true,350,850,348,848,-2,-2,2,true,true,true,-1.0
1,2,0.5,0.5,false,true,250,200,250,200,0,0,0,false,false,false,-1.0
1,2,0.5,0.5,false,false,850,300,832,282,-18,-18,18,true,true,true,138.31
1,2,0.5,0.5,false,false,300,300,799,349,499,49,1,true,true,true,-1.0
1,2,0.5,0.5,false,false,250,250,200,200,-50,-50,50,false,false,false,-1.0
1,2,0.5,0.5,false,false,200,850,198,848,-2,-2,2,true,true,true,-1.0
1,2,0.5,0.5,false,false,250,250,274,224,24,-26,26,true,true,true,-1.0
1,2,0.5,0.5,false,false,300,300,298,298,-2,-2,2,true,true,true,-1.0
1,2,0.5,0.5,false,false,300,300,898,848,598,548,2,true,true,true,-1.0
1,2,0.5,0.5,false,false,250,300,248,298,-2,-2,2,true,true,true,-1.0
1,2,0.5,0.5,false,false,350,200,348,198,-2,-2,2,true,true,true,-1.0
1,2,0.5,0.5,false,false,900,250,898,248,-2,-2,2,true,true,true,-1.0
1,2,0.5,0.5,false,false,200,350,198,348,-2,-2,2,true,true,true,-1.0
1,2,0.5,0.5,false,false,300,200,899,849,599,649,1,true,true,true,-1.0
1,2,0.5,0.5,false,false,300,250,399,299,99,49,1,true,true,true,-1.0
1,2,0.5,0.5,false,false,300,900,298,898,-2,-2,2,true,true,true,-1.0
1,2,0.5,0.5,false,false,200,250,248,798,48,548,2,true,true,true,-1.0
1,2,0.5,0.5,false,false,350,350,348,348,-2,-2,2,true,true,true,-1.0
1,2,0.5,0.5,false,false,300,250,286,236,-14,-14,14,true,true,true,-1.0
1,2,0.5,0.5,false,false,250,850,248,848,-2,-2,2,true,true,true,-1.0
1,2,0.5,0.5,false,false,350,300,948,798,598,498,2,true,true,true,-1.0
1,2,0.5,0.5,false,false,300,200,294,194,-6,-6,6,true,true,true,-1.0
2,0,0.5,0.5,true,false,350,200,947,297,597,97,3,true,false,true,628.349
2,0,0.5,0.5,true,false,850,300,898,798,48,498,2,true,true,true,-1.0
2,0,0.5,0.5,true,false,300,850,297,847,-3,-3,3,true,true,true,-1.0
2,0,0.5,0.5,true,false,300,250,898,798,598,548,2,true,true,true,-1.0
2,0,0.5,0.5,true,false,300,250,796,296,496,46,4,true,true,true,-1.0
2,0,0.5,0.5,true,false,300,850,297,847,-3,-3,3,true,true,true,-1.0
2,0,0.5,0.5,true,false,300,300,297,297,-3,-3,3,false,false,false,-1.0
2,0,0.5,0.5,true,false,250,200,250,200,0,0,0,true,true,true,-1.0
2,0,0.5,0.5,true,false,300,900,797,947,497,47,3,true,true,true,-1.0
2,0,0.5,0.5,true,false,200,200,899,349,699,149,1,true,true,true,-1.0
2,0,0.5,0.5,true,false,300,250,300,250,0,0,0,true,true,true,-1.0
2,0,0.5,0.5,true,false,850,300,896,796,46,496,4,true,true,true,-1.0
2,0,0.5,0.5,true,false,850,200,850,200,0,0,0,true,true,true,-1.0
2,0,0.5,0.5,true,false,200,250,197,247,-3,-3,3,true,true,true,-1.0
2,0,0.5,0.5,true,false,850,200,850,200,0,0,0,true,true,true,-1.0
2,0,0.5,0.5,true,false,200,350,197,347,-3,-3,3,true,true,true,-1.0
2,0,0.5,0.5,true,false,300,300,300,300,0,0,0,true,true,true,-1.0
2,0,0.5,0.5,true,false,300,250,899,799,599,549,1,true,true,true,-1.0
2,0,0.5,0.5,true,false,300,300,297,297,-3,-3,3,true,true,true,-1.0
2,0,0.5,0.5,true,false,200,300,196,296,-4,-4,4,true,true,true,-1.0
2,0,0.5,0.5,false,false,300,250,297,247,-3,-3,3,true,true,true,118.757
2,0,0.5,0.5,false,false,300,200,797,347,497,147,3,true,true,true,-1.0
2,0,0.5,0.5,false,false,250,300,247,297,-3,-3,3,true,true,true,-1.0
2,0,0.5,0.5,false,false,200,200,197,197,-3,-3,3,true,true,true,-1.0
2,0,0.5,0.5,false,false,850,250,898,798,48,548,2,true,true,true,-1.0
2,0,0.5,0.5,false,false,300,250,797,297,497,47,3,true,true,true,-1.0
2,0,0.5,0.5,false,false,300,300,948,798,648,498,2,true,true,true,-1.0
2,0,0.5,0.5,false,false,300,200,296,196,-4,-4,4,true,true,true,-1.0
2,0,0.5,0.5,false,false,200,300,246,796,46,496,4,true,true,true,-1.0
2,0,0.5,0.5,false,false,300,250,300,250,0,0,0,true,true,true,-1.0
2,0,0.5,0.5,false,false,250,850,799,899,549,49,1,true,true,true,-1.0
2,0,0.5,0.5,false,false,300,300,295,295,-5,-5,5,false,false,false,-1.0
2,0,0.5,0.5,false,false,250,300,797,347,547,47,3,true,true,true,-1.0
2,0,0.5,0.5,false,false,200,300,195,295,-5,-5,5,false,false,false,-1.0
2,0,0.5,0.5,false,false,300,300,297,297,-3,-3,3,true,true,true,-1.0
2,0,0.5,0.5,false,false,300,850,300,850,0,0,0,true,true,true,-1.0
2,0,0.5,0.5,false,false,250,350,247,347,-3,-3,3,true,true,true,-1.0
2,0,0.5,0.5,false,false,200,300,249,799,49,499,1,true,true,true,-1.0
2,0,0.5,0.5,false,false,250,250,898,798,648,548,2,true,true,true,-1.0
2,0,0.5,0.5,false,false,300,850,297,847,-3,-3,3,true,true,true,-1.0
2,1,0.5,0.5,true,false,850,850,847,847,-3,-3,3,true,true,true,827.399
2,1,0.5,0.5,true,false,250,850,247,847,-3,-3,3,true,true,true,-1.0
2,1,0.5,0.5,true,false,250,200,250,200,0,0,0,true,true,true,-1.0
2,1,0.5,0.5,true,false,250,250,798,398,548,148,2,true,true,true,-1.0
2,1,0.5,0.5,true,false,850,300,847,297,-3,-3,3,true,true,true,-1.0
2,1,0.5,0.5,true,false,200,300,797,897,597,597,3,true,true,true,-1.0
2,1,0.5,0.5,true,false,850,850,850,850,0,0,0,true,true,true,-1.0
2,1,0.5,0.5,true,false,200,850,200,850,0,0,0,true,true,true,-1.0
2,1,0.5,0.5,true,false,250,300,298,348,48,48,2,true,true,true,-1.0
2,1,0.5,0.5,true,false,300,850,299,849,-1,-1,1,true,true,true,-1.0
2,1,0.5,0.5,true,false,350,250,347,247,-3,-3,3,true,true,true,-1.0
2,1,0.5,0.5,true,false,300,200,297,197,-3,-3,3,true,true,true,-1.0
2,1,0.5,0.5,true,false,300,250,299,249,-1,-1,1,true,true,true,-1.0
2,1,0.5,0.5,true,false,200,200,200,200,0,0,0,true,true,true,-1.0
2,1,0.5,0.5,true,false,850,300,850,300,0,0,0,true,true,true,-1.0
2,1,0.5,0.5,true,false,300,300,250,250,-50,-50,50,false,false,false,-1.0
2,1,0.5,0.5,true,false,300,200,399,249,99,49,1,true,true,true,-1.0
2,1,0.5,0.5,true,false,250,350,200,300,-50,-50,50,true,true,true,-1.0
2,1,0.5,0.5,true,false,850,850,847,847,-3,-3,3,true,true,true,-1.0
2,1,0.5,0.5,true,false,900,850,897,847,-3,-3,3,true,true,true,-1.0
2,1,0.5,0.5,false,false,850,350,850,350,0,0,0,true,true,true,180.047
2,1,0.5,0.5,false,false,300,300,798,348,498,48,2,true,true,true,-1.0
2,1,0.5,0.5,false,false,200,300,398,798,198,498,2,true,true,true,-1.0
2,1,0.5,0.5,false,false,200,200,797,347,597,147,3,true,true,true,-1.0
2,1,0.5,0.5,false,false,350,900,343,893,-7,-7,7,true,true,true,-1.0
2,1,0.5,0.5,false,false,300,850,297,847,-3,-3,3,true,true,true,-1.0
2,1,0.5,0.5,false,false,300,850,299,849,-1,-1,1,true,true,true,-1.0
2,1,0.5,0.5,false,false,250,250,250,250,0,0,0,true,true,true,-1.0
2,1,0.5,0.5,false,false,850,850,849,849,-1,-1,1,true,true,true,-1.0
2,1,0.5,0.5,false,false,300,300,899,849,599,549,1,true,true,true,-1.0
2,1,0.5,0.5,false,false,250,300,247,297,-3,-3,3,true,true,true,-1.0
2,1,0.5,0.5,false,false,850,250,848,248,-2,-2,2,true,true,true,-1.0
2,1,0.5,0.5,false,false,200,250,799,349,599,99,1,true,true,true,-1.0
2,1,0.5,0.5,false,false,250,250,248,248,-2,-2,2,true,true,true,-1.0
2,1,0.5,0.5,false,false,300,250,297,247,-3,-3,3,true,true,true,-1.0
2,1,0.5,0.5,false,false,200,850,200,850,0,0,0,true,true,true,-1.0
2,1,0.5,0.5,false,false,350,850,341,841,-9,-9,9,true,true,true,-1.0
2,1,0.5,0.5,false,false,250,300,798,898,548,598,2,true,true,true,-1.0
2,1,0.5,0.5,false,false,200,200,248,898,48,698,2,true,true,true,-1.0
2,1,0.5,0.5,false,false,200,300,197,297,-3,-3,3,true,true,true,-1.0
2,2,0.5,0.5,true,true,850,250,850,250,0,0,0,true,true,true,508.181
2,2,0.5,0.5,true,true,200,200,249,249,49,49,1,true,false,true,-1.0
2,2,0.5,0.5,true,true,250,300,298,798,48,498,2,true,true,true,-1.0
2,2,0.5,0.5,true,true,350,200,349,199,-1,-1,1,true,true,true,-1.0
2,2,0.5,0.5,true,true,200,300,849,849,649,549,1,true,true,true,-1.0
2,2,0.5,0.5,true,true,900,850,899,849,-1,-1,1,true,true,true,-1.0
2,2,0.5,0.5,true,true,850,850,849,849,-1,-1,1,true,true,true,-1.0
2,2,0.5,0.5,true,true,350,200,898,298,548,98,2,true,true,true,-1.0
2,2,0.5,0.5,true,true,350,850,349,849,-1,-1,1,true,true,true,-1.0
2,2,0.5,0.5,true,true,300,200,299,199,-1,-1,1,true,true,true,-1.0
2,2,0.5,0.5,true,true,350,250,899,349,549,99,1,true,true,true,-1.0
2,2,0.5,0.5,true,true,300,850,799,899,499,49,1,true,true,true,-1.0
2,2,0.5,0.5,true,true,300,250,799,299,499,49,1,true,true,true,-1.0
2,2,0.5,0.5,true,true,300,300,798,348,498,48,2,true,true,true,-1.0
2,2,0.5,0.5,true,true,300,300,348,798,48,498,2,true,true,true,-1.0
2,2,0.5,0.5,true,true,250,300,248,298,-2,-2,2,true,true,true,-1.0
2,2,0.5,0.5,true,true,200,250,199,249,-1,-1,1,true,true,true,-1.0
2,2,0.5,0.5,true,true,350,300,350,300,0,0,0,true,true,true,-1.0
2,2,0.5,0.5,true,true,350,250,399,799,49,549,1,true,true,true,-1.0
2,2,0.5,0.5,true,true,250,300,299,799,49,499,1,true,true,true,-1.0
2,2,0.5,0.5,true,false,200,250,198,248,-2,-2,2,true,true,true,602.463
2,2,0.5,0.5,true,false,850,300,849,299,-1,-1,1,true,true,true,-1.0
2,2,0.5,0.5,true,false,350,250,350,250,0,0,0,true,true,true,-1.0
2,2,0.5,0.5,true,false,300,200,300,200,0,0,0,true,true,true,-1.0
2,2,0.5,0.5,true,false,250,200,798,348,548,148,2,true,true,true,-1.0
2,2,0.5,0.5,true,false,300,200,300,200,0,0,0,true,true,true,-1.0
2,2,0.5,0.5,true,false,250,300,798,948,548,648,2,true,true,true,-1.0
2,2,0.5,0.5,true,false,300,300,798,348,498,48,2,true,true,true,-1.0
2,2,0.5,0.5,true,false,250,850,248,848,-2,-2,2,true,true,true,-1.0
2,2,0.5,0.5,true,false,250,200,299,249,49,49,1,true,true,true,-1.0
2,2,0.5,0.5,true,false,250,850,249,849,-1,-1,1,true,true,true,-1.0
2,2,0.5,0.5,true,false,200,250,198,248,-2,-2,2,true,true,true,-1.0
2,2,0.5,0.5,true,false,250,200,246,196,-4,-4,4,true,true,true,-1.0
2,2,0.5,0.5,true,false,250,200,299,299,49,99,1,true,true,true,-1.0
2,2,0.5,0.5,true,false,350,300,348,298,-2,-2,2,true,true,true,-1.0
2,2,0.5,0.5,true,false,250,250,249,799,-1,549,1,true,true,true,-1.0
2,2,0.5,0.5,true,false,250,850,249,849,-1,-1,1,true,true,true,-1.0
2,2,0.5,0.5,true,false,300,300,300,300,0,0,0,true,true,true,-1.0
2,2,0.5,0.5,true,false,200,300,238,888,38,588,12,true,true,true,-1.0
2,2,0.5,0.5,true,false,300,850,299,849,-1,-1,1,true,true,true,-1.0
2,2,0.5,0.5,false,true,300,850,299,849,-1,-1,1,true,true,true,180.257
2,2,0.5,0.5,false,true,850,350,850,350,0,0,0,true,true,true,-1.0
2,2,0.5,0.5,false,true,850,200,899,799,49,599,1,true,true,true,-1.0
2,2,0.5,0.5,false,true,850,850,849,849,-1,-1,1,true,true,true,-1.0
2,2,0.5,0.5,false,true,250,850,249,849,-1,-1,1,true,true,true,-1.0
2,2,0.5,0.5,false,true,850,300,850,300,0,0,0,true,true,true,-1.0
2,2,0.5,0.5,false,true,300,350,898,898,598,548,2,true,true,true,-1.0
2,2,0.5,0.5,false,true,200,200,299,249,99,49,1,true,true,true,-1.0
2,2,0.5,0.5,false,true,250,300,250,300,0,0,0,true,true,true,-1.0
2,2,0.5,0.5,false,true,200,200,248,248,48,48,2,true,true,true,-1.0
2,2,0.5,0.5,false,true,300,250,299,249,-1,-1,1,true,true,true,-1.0
2,2,0.5,0.5,false,true,300,200,300,200,0,0,0,true,true,true,-1.0
2,2,0.5,0.5,false,true,300,350,331,881,31,531,19,true,true,true,-1.0
2,2,0.5,0.5,false,true,250,300,848,848,598,548,2,true,true,true,-1.0
2,2,0.5,0.5,false,true,300,200,797,947,497,747,3,true,true,true,-1.0
2,2,0.5,0.5,false,true,350,300,396,796,46,496,4,true,true,true,-1.0
2,2,0.5,0.5,false,true,300,350,798,948,498,598,2,true,true,true,-1.0
2,2,0.5,0.5,false,true,300,300,898,798,598,498,2,true,true,true,-1.0
2,2,0.5,0.5,false,true,250,300,248,298,-2,-2,2,true,true,true,-1.0
2,2,0.5,0.5,false,true,250,300,249,299,-1,-1,1,true,true,true,-1.0
2,2,0.5,0.5,false,false,350,300,897,347,547,47,3,true,true,true,96.762
2,2,0.5,0.5,false,false,300,300,298,298,-2,-2,2,true,true,true,-1.0
2,2,0.5,0.5,false,false,250,200,250,200,0,0,0,true,true,true,-1.0
2,2,0.5,0.5,false,false,350,200,349,199,-1,-1,1,true,true,true,-1.0
2,2,0.5,0.5,false,false,850,350,849,349,-1,-1,1,true,true,true,-1.0
2,2,0.5,0.5,false,false,250,300,349,799,99,499,1,true,true,true,-1.0
2,2,0.5,0.5,false,false,200,300,298,798,98,498,2,true,true,true,-1.0
2,2,0.5,0.5,false,false,250,250,297,347,47,97,3,true,false,true,-1.0
2,2,0.5,0.5,false,false,850,300,850,300,0,0,0,true,true,true,-1.0
2,2,0.5,0.5,false,false,300,250,798,298,498,48,2,true,true,true,-1.0
2,2,0.5,0.5,false,false,200,250,199,249,-1,-1,1,true,true,true,-1.0
2,2,0.5,0.5,false,false,300,200,799,399,499,199,1,true,true,true,-1.0
2,2,0.5,0.5,false,false,200,250,199,249,-1,-1,1,true,true,true,-1.0
2,2,0.5,0.5,false,false,300,250,398,798,98,548,2,true,true,true,-1.0
2,2,0.5,0.5,false,false,850,250,850,250,0,0,0,true,true,true,-1.0
2,2,0.5,0.5,false,false,850,200,850,200,0,0,0,true,true,true,-1.0
2,2,0.5,0.5,false,false,250,350,798,398,548,48,2,true,true,true,-1.0
2,2,0.5,0.5,false,false,300,300,298,298,-2,-2,2,true,true,true,-1.0
2,2,0.5,0.5,false,false,350,250,899,299,549,49,1,true,true,true,-1.0
2,2,0.5,0.5,false,false,250,250,298,798,48,548,2,true,true,true,-1.0
0,0,0.5,0.5,false,false,300,200,797,247,497,47,3,true,true,true,0.19
0,0,0.5,0.5,false,false,300,250,899,849,599,599,1,true,true,true,-1.0
0,0,0.5,0.5,false,false,250,250,247,247,-3,-3,3,false,false,false,-1.0
0,0,0.5,0.5,false,false,200,350,197,347,-3,-3,3,true,true,true,-1.0
0,0,0.5,0.5,false,false,300,250,298,248,-2,-2,2,true,true,true,-1.0
0,0,0.5,0.5,false,false,300,200,797,247,497,47,3,true,true,true,-1.0
0,0,0.5,0.5,false,false,850,850,848,848,-2,-2,2,true,true,true,-1.0
0,0,0.5,0.5,false,false,300,200,298,198,-2,-2,2,true,true,true,-1.0
0,0,0.5,0.5,false,false,200,200,198,198,-2,-2,2,true,true,true,-1.0
0,0,0.5,0.5,false,false,250,850,797,897,547,47,3,true,true,true,-1.0
0,0,0.5,0.5,false,false,900,200,898,198,-2,-2,2,true,true,true,-1.0
0,0,0.5,0.5,false,false,250,250,799,899,549,649,1,true,true,true,-1.0
0,0,0.5,0.5,false,false,250,350,247,347,-3,-3,3,true,true,true,-1.0
0,0,0.5,0.5,false,false,200,250,799,899,599,649,1,true,true,true,-1.0
0,0,0.5,0.5,false,false,200,850,197,847,-3,-3,3,false,false,false,-1.0
0,0,0.5,0.5,false,false,350,350,347,347,-3,-3,3,true,true,true,-1.0
0,0,0.5,0.5,false,false,850,200,848,198,-2,-2,2,true,true,true,-1.0
0,0,0.5,0.5,false,false,250,200,247,197,-3,-3,3,false,false,false,-1.0
0,0,0.5,0.5,false,false,300,250,296,246,-4,-4,4,true,true,true,-1.0
0,0,0.5,0.5,false,false,300,850,297,847,-3,-3,3,true,true,true,-1.0
0,1,0.5,0.5,false,false,250,200,246,196,-4,-4,4,true,true,true,0.293
0,1,0.5,0.5,false,false,300,350,296,346,-4,-4,4,true,true,true,-1.0
0,1,0.5,0.5,false,false,250,200,848,848,598,648,2,true,true,true,-1.0
0,1,0.5,0.5,false,false,850,350,846,346,-4,-4,4,true,true,true,-1.0
0,1,0.5,0.5,false,false,250,900,249,899,-1,-1,1,true,true,true,-1.0
0,1,0.5,0.5,false,false,850,200,848,198,-2,-2,2,false,false,false,-1.0
0,1,0.5,0.5,false,false,350,200,346,196,-4,-4,4,true,true,true,-1.0
0,1,0.5,0.5,false,false,200,300,348,898,148,598,2,true,true,true,-1.0
0,1,0.5,0.5,false,false,300,300,799,349,499,49,1,true,true,true,-1.0
0,1,0.5,0.5,false,false,350,300,949,799,599,499,1,true,true,true,-1.0
0,1,0.5,0.5,false,false,350,300,346,296,-4,-4,4,true,true,true,-1.0
0,1,0.5,0.5,false,false,250,300,897,847,647,547,3,true,true,true,-1.0
0,1,0.5,0.5,false,false,250,300,298,848,48,548,2,true,true,true,-1.0
0,1,0.5,0.5,false,false,300,200,296,196,-4,-4,4,true,true,true,-1.0
0,1,0.5,0.5,false,false,300,250,799,399,499,149,1,true,true,true,-1.0
0,1,0.5,0.5,false,false,300,250,296,246,-4,-4,4,true,true,true,-1.0
0,1,0.5,0.5,false,false,250,200,798,298,548,98,2,true,true,true,-1.0
0,1,0.5,0.5,false,false,250,200,799,299,549,99,1,true,true,true,-1.0
0,1,0.5,0.5,false,false,300,350,296,346,-4,-4,4,true,true,true,-1.0
0,1,0.5,0.5,false,false,300,300,799,899,499,599,1,true,true,true,-1.0
0,2,0.5,0.5,false,true,200,250,298,298,98,48,2,true,true,true,383.435
0,2,0.5,0.5,false,true,250,300,298,898,48,598,2,true,true,true,-1.0
0,2,0.5,0.5,false,true,300,850,299,849,-1,-1,1,true,true,true,-1.0
0,2,0.5,0.5,false,true,850,350,846,346,-4,-4,4,true,true,true,-1.0
0,2,0.5,0.5,false,true,900,850,898,848,-2,-2,2,true,true,true,-1.0
0,2,0.5,0.5,false,true,350,350,348,348,-2,-2,2,true,true,true,-1.0
0,2,0.5,0.5,false,true,300,300,348,798,48,498,2,true,true,true,-1.0
0,2,0.5,0.5,false,true,300,300,296,296,-4,-4,4,true,true,true,-1.0
0,2,0.5,0.5,false,true,300,250,348,798,48,548,2,true,true,true,-1.0
0,2,0.5,0.5,false,true,200,200,196,196,-4,-4,4,true,true,true,-1.0
0,2,0.5,0.5,false,true,250,300,246,296,-4,-4,4,true,true,true,-1.0
0,2,0.5,0.5,false,true,350,300,349,299,-1,-1,1,true,true,true,-1.0
0,2,0.5,0.5,false,true,300,850,297,847,-3,-3,3,true,true,true,-1.0
0,2,0.5,0.5,false,true,350,250,897,297,547,47,3,true,true,true,-1.0
0,2,0.5,0.5,false,true,250,200,298,298,48,98,2,true,true,true,-1.0
0,2,0.5,0.5,false,true,300,300,799,899,499,599,1,true,true,true,-1.0
0,2,0.5,0.5,false,true,250,850,246,846,-4,-4,4,true,true,true,-1.0
0,2,0.5,0.5,false,true,850,850,848,848,-2,-2,2,true,true,true,-1.0
0,2,0.5,0.5,false,true,850,200,846,196,-4,-4,4,true,true,true,-1.0
0,2,0.5,0.5,false,true,300,900,299,899,-1,-1,1,true,true,true,-1.0
0,2,0.5,0.5,false,false,200,350,199,349,-1,-1,1,true,true,true,79.174
0,2,0.5,0.5,false,false,350,300,346,296,-4,-4,4,true,true,true,-1.0
0,2,0.5,0.5,false,false,250,200,246,196,-4,-4,4,true,true,true,-1.0
0,2,0.5,0.5,false,false,250,300,249,299,-1,-1,1,true,true,true,-1.0
0,2,0.5,0.5,false,false,350,350,346,346,-4,-4,4,true,true,true,-1.0
0,2,0.5,0.5,false,false,300,200,797,947,497,747,3,true,true,true,-1.0
0,2,0.5,0.5,false,false,250,850,246,846,-4,-4,4,true,true,true,-1.0
0,2,0.5,0.5,false,false,200,300,248,798,48,498,2,true,true,true,-1.0
0,2,0.5,0.5,false,false,300,250,298,248,-2,-2,2,true,true,true,-1.0
0,2,0.5,0.5,false,false,250,250,348,798,98,548,2,true,true,true,-1.0
0,2,0.5,0.5,false,false,300,300,348,798,48,498,2,true,true,true,-1.0
0,2,0.5,0.5,false,false,200,250,248,348,48,98,2,true,true,true,-1.0
0,2,0.5,0.5,false,false,850,300,846,296,-4,-4,4,true,true,true,-1.0
0,2,0.5,0.5,false,false,300,900,297,897,-3,-3,3,true,true,true,-1.0
0,2,0.5,0.5,false,false,350,200,348,198,-2,-2,2,true,true,true,-1.0
0,2,0.5,0.5,false,false,300,250,298,248,-2,-2,2,true,true,true,-1.0
0,2,0.5,0.5,false,false,350,250,396,796,46,546,4,true,true,true,-1.0
0,2,0.5,0.5,false,false,200,300,799,349,599,49,1,true,true,true,-1.0
0,2,0.5,0.5,false,false,850,200,846,196,-4,-4,4,false,false,false,-1.0
0,2,0.5,0.5,false,false,250,350,247,347,-3,-3,3,true,true,true,-1.0
1,0,0.5,0.5,false,false,300,850,297,847,-3,-3,3,true,true,true,0.339
1,0,0.5,0.5,false,false,300,200,300,200,0,0,0,true,true,true,-1.0
1,0,0.5,0.5,false,false,850,850,847,847,-3,-3,3,true,true,true,-1.0
1,0,0.5,0.5,false,false,200,250,898,798,698,548,2,true,true,true,-1.0
1,0,0.5,0.5,false,false,200,200,195,195,-5,-5,5,true,true,true,-1.0
1,0,0.5,0.5,false,false,250,350,799,399,549,49,1,true,true,true,-1.0
1,0,0.5,0.5,false,false,300,850,300,850,0,0,0,true,true,true,-1.0
1,0,0.5,0.5,false,false,250,250,799,299,549,49,1,true,true,true,-1.0
1,0,0.5,0.5,false,false,300,250,297,247,-3,-3,3,true,true,true,-1.0
1,0,0.5,0.5,false,false,350,200,396,246,46,46,4,true,true,true,-1.0
1,0,0.5,0.5,false,false,250,300,799,899,549,599,1,true,true,true,-1.0
1,0,0.5,0.5,false,false,300,250,799,299,499,49,1,true,true,true,-1.0
1,0,0.5,0.5,false,false,850,250,847,247,-3,-3,3,true,true,true,-1.0
1,0,0.5,0.5,false,false,250,300,245,295,-5,-5,5,true,true,true,-1.0
1,0,0.5,0.5,false,false,350,200,347,197,-3,-3,3,true,true,true,-1.0
1,0,0.5,0.5,false,false,200,300,197,297,-3,-3,3,false,false,false,-1.0
1,0,0.5,0.5,false,false,300,200,797,347,497,147,3,true,true,true,-1.0
1,0,0.5,0.5,false,false,200,300,197,297,-3,-3,3,true,true,true,-1.0
1,0,0.5,0.5,false,false,200,250,247,297,47,47,3,true,true,true,-1.0
1,0,0.5,0.5,false,false,250,900,247,897,-3,-3,3,true,true,true,-1.0
1,1,0.5,0.5,false,false,250,350,200,300,-50,-50,50,true,true,true,1.193
1,1,0.5,0.5,false,false,200,250,248,798,48,548,2,true,true,true,-1.0
1,1,0.5,0.5,false,false,300,850,250,800,-50,-50,50,true,true,true,-1.0
1,1,0.5,0.5,false,false,850,300,800,250,-50,-50,50,true,true,true,-1.0
1,1,0.5,0.5,false,false,300,300,898,898,598,598,2,true,true,true,-1.0
1,1,0.5,0.5,false,false,250,300,848,898,598,598,2,true,true,true,-1.0
1,1,0.5,0.5,false,false,300,250,348,298,48,48,2,true,true,true,-1.0
1,1,0.5,0.5,false,false,250,300,200,250,-50,-50,50,false,false,false,-1.0
1,1,0.5,0.5,false,false,200,300,200,300,0,0,0,true,true,true,-1.0
1,1,0.5,0.5,false,false,350,250,300,200,-50,-50,50,false,false,false,-1.0
1,1,0.5,0.5,false,false,200,300,249,799,49,499,1,true,true,true,-1.0
1,1,0.5,0.5,false,false,250,200,200,150,-50,-50,50,true,true,true,-1.0
1,1,0.5,0.5,false,false,250,850,200,800,-50,-50,50,true,true,true,-1.0
1,1,0.5,0.5,false,false,300,850,250,800,-50,-50,50,true,true,true,-1.0
1,1,0.5,0.5,false,false,200,300,195,295,-5,-5,5,true,true,true,-1.0
1,1,0.5,0.5,false,false,200,300,197,297,-3,-3,3,true,true,true,-1.0
1,1,0.5,0.5,false,false,300,300,300,300,0,0,0,true,true,true,-1.0
1,1,0.5,0.5,false,false,350,300,348,298,-2,-2,2,true,true,true,-1.0
1,1,0.5,0.5,false,false,350,200,399,799,49,599,1,true,true,true,-1.0
1,1,0.5,0.5,false,false,300,350,250,300,-50,-50,50,true,true,true,-1.0
1,2,0.5,0.5,false,true,900,200,900,200,0,0,0,true,true,true,603.857
1,2,0.5,0.5,false,true,300,900,298,898,-2,-2,2,true,true,true,-1.0
1,2,0.5,0.5,false,true,200,900,198,898,-2,-2,2,true,true,true,-1.0
1,2,0.5,0.5,false,true,300,300,769,319,469,19,31,true,true,true,-1.0
1,2,0.5,0.5,false,true,250,350,200,300,-50,-50,50,true,true,true,-1.0
1,2,0.5,0.5,false,true,300,850,299,849,-1,-1,1,true,true,true,-1.0
1,2,0.5,0.5,false,true,200,250,248,798,48,548,2,true,false,true,-1.0
1,2,0.5,0.5,false,true,200,300,248,798,48,498,2,true,true,true,-1.0
1,2,0.5,0.5,false,true,250,300,248,298,-2,-2,2,true,true,true,-1.0
1,2,0.5,0.5,false,true,850,250,850,250,0,0,0,true,true,true,-1.0
1,2,0.5,0.5,false,true,250,900,248,898,-2,-2,2,true,true,true,-1.0
1,2,0.5,0.5,false,true,350,300,399,799,49,499,1,true,true,true,-1.0
1,2,0.5,0.5,false,true,300,250,797,347,497,97,3,true,false,true,-1.0
1,2,0.5,0.5,false,true,850,350,848,348,-2,-2,2,true,true,true,-1.0
1,2,0.5,0.5,false,true,300,300,298,298,-2,-2,2,true,true,true,-1.0
1,2,0.5,0.5,false,true,300,850,300,850,0,0,0,true,true,true,-1.0
1,2,0.5,0.5,false,true,200,200,249,799,49,599,1,true,true,true,-1.0
1,2,0.5,0.5,false,true,300,850,798,898,498,48,2,true,true,true,-1.0
1,2,0.5,0.5,false,true,250,850,298,898,48,48,2,true,true,true,-1.0
1,2,0.5,0.5,false,true,250,850,249,849,-1,-1,1,true,true,true,-1.0
1,2,0.5,0.5,false,false,300,300,298,298,-2,-2,2,true,true,true,143.332
1,2,0.5,0.5,false,false,300,200,799,299,499,99,1,true,true,true,-1.0
1,2,0.5,0.5,false,false,850,350,848,348,-2,-2,2,true,true,true,-1.0
1,2,0.5,0.5,false,false,300,300,250,250,-50,-50,50,false,false,false,-1.0
1,2,0.5,0.5,false,false,250,250,297,297,47,47,3,true,true,true,-1.0
1,2,0.5,0.5,false,false,200,850,199,849,-1,-1,1,true,true,true,-1.0
1,2,0.5,0.5,false,false,300,850,298,848,-2,-2,2,true,true,true,-1.0
1,2,0.5,0.5,false,false,250,200,200,150,-50,-50,50,false,false,false,-1.0
1,2,0.5,0.5,false,false,300,300,349,799,49,499,1,true,true,true,-1.0
1,2,0.5,0.5,false,false,300,850,298,848,-2,-2,2,true,true,true,-1.0
1,2,0.5,0.5,false,false,200,300,198,298,-2,-2,2,true,true,true,-1.0
1,2,0.5,0.5,false,false,850,200,850,200,0,0,0,true,true,true,-1.0
1,2,0.5,0.5,false,false,250,250,249,249,-1,-1,1,true,true,true,-1.0
1,2,0.5,0.5,false,false,850,250,850,250,0,0,0,true,true,true,-1.0
1,2,0.5,0.5,false,false,200,300,849,899,649,599,1,true,true,true,-1.0
1,2,0.5,0.5,false,false,850,200,850,200,0,0,0,true,true,true,-1.0
1,2,0.5,0.5,false,false,300,300,341,341,41,41,9,true,true,true,-1.0
1,2,0.5,0.5,false,false,250,250,799,899,549,649,1,true,true,true,-1.0
1,2,0.5,0.5,false,false,300,250,298,248,-2,-2,2,true,true,true,-1.0
1,2,0.5,0.5,false,false,350,200,349,199,-1,-1,1,true,true,true,-1.0
2,0,0.5,0.5,true,false,250,250,299,799,49,549,1,true,true,true,633.556
2,0,0.5,0.5,true,false,250,900,247,897,-3,-3,3,true,true,true,-1.0
2,0,0.5,0.5,true,false,300,300,797,347,497,47,3,true,true,true,-1.0
2,0,0.5,0.5,true,false,200,350,195,345,-5,-5,5,false,false,false,-1.0
2,0,0.5,0.5,true,false,300,200,397,247,97,47,3,true,false,true,-1.0
2,0,0.5,0.5,true,false,300,250,799,899,499,649,1,true,true,true,-1.0
2,0,0.5,0.5,true,false,300,200,898,798,598,598,2,true,true,true,-1.0
2,0,0.5,0.5,true,false,850,300,845,295,-5,-5,5,true,true,true,-1.0
2,0,0.5,0.5,true,false,300,300,297,297,-3,-3,3,true,true,true,-1.0
2,0,0.5,0.5,true,false,300,350,797,397,497,47,3,true,true,true,-1.0
2,0,0.5,0.5,true,false,200,250,298,798,98,548,2,true,true,true,-1.0
2,0,0.5,0.5,true,false,200,900,197,897,-3,-3,3,false,false,false,-1.0
2,0,0.5,0.5,true,false,350,200,397,247,47,47,3,true,true,true,-1.0
2,0,0.5,0.5,true,false,350,300,348,298,-2,-2,2,true,true,true,-1.0
2,0,0.5,0.5,true,false,350,250,345,245,-5,-5,5,true,true,true,-1.0
2,0,0.5,0.5,true,false,250,350,245,345,-5,-5,5,true,true,true,-1.0
2,0,0.5,0.5,true,false,300,850,297,847,-3,-3,3,true,true,true,-1.0
2,0,0.5,0.5,true,false,200,250,299,299,99,49,1,true,true,true,-1.0
2,0,0.5,0.5,true,false,300,250,898,848,598,598,2,true,true,true,-1.0
2,0,0.5,0.5,true,false,250,300,897,847,647,547,3,true,true,true,-1.0
2,0,0.5,0.5,false,false,250,900,247,897,-3,-3,3,true,true,true,98.171
2,0,0.5,0.5,false,false,250,300,799,949,549,649,1,true,true,true,-1.0
2,0,0.5,0.5,false,false,200,250,299,849,99,599,1,true,true,true,-1.0
2,0,0.5,0.5,false,false,850,250,845,245,-5,-5,5,true,true,true,-1.0
2,0,0.5,0.5,false,false,250,850,247,847,-3,-3,3,true,true,true,-1.0
2,0,0.5,0.5,false,false,350,300,350,300,0,0,0,true,true,true,-1.0
2,0,0.5,0.5,false,false,850,200,845,195,-5,-5,5,true,true,true,-1.0
2,0,0.5,0.5,false,false,300,200,296,196,-4,-4,4,true,true,true,-1.0
2,0,0.5,0.5,false,false,200,200,197,197,-3,-3,3,true,true,true,-1.0
2,0,0.5,0.5,false,false,350,250,897,297,547,47,3,true,true,true,-1.0
2,0,0.5,0.5,false,false,300,300,848,898,548,598,2,true,true,true,-1.0
2,0,0.5,0.5,false,false,850,250,848,248,-2,-2,2,true,true,true,-1.0
2,0,0.5,0.5,false,false,300,850,799,899,499,49,1,true,true,true,-1.0
2,0,0.5,0.5,false,false,850,850,847,847,-3,-3,3,true,true,true,-1.0
2,0,0.5,0.5,false,false,250,250,898,798,648,548,2,true,true,true,-1.0
2,0,0.5,0.5,false,false,850,250,847,247,-3,-3,3,true,true,true,-1.0
2,0,0.5,0.5,false,false,300,300,799,349,499,49,1,true,true,true,-1.0
2,0,0.5,0.5,false,false,350,250,345,245,-5,-5,5,true,true,true,-1.0
2,0,0.5,0.5,false,false,200,200,197,197,-3,-3,3,true,true,true,-1.0
2,0,0.5,0.5,false,false,300,350,300,350,0,0,0,true,true,true,-1.0
2,1,0.5,0.5,true,false,200,300,150,250,-50,-50,50,false,false,false,898.274
2,1,0.5,0.5,true,false,250,250,899,799,649,549,1,true,true,true,-1.0
2,1,0.5,0.5,true,false,350,300,899,849,549,549,1,true,true,true,-1.0
2,1,0.5,0.5,true,false,300,300,300,300,0,0,0,true,true,true,-1.0
2,1,0.5,0.5,true,false,200,350,199,349,-1,-1,1,false,false,false,-1.0
2,1,0.5,0.5,true,false,250,300,247,297,-3,-3,3,true,true,true,-1.0
2,1,0.5,0.5,true,false,350,350,347,347,-3,-3,3,true,true,true,-1.0
2,1,0.5,0.5,true,false,350,200,399,799,49,599,1,true,true,true,-1.0
2,1,0.5,0.5,true,false,350,250,300,200,-50,-50,50,false,false,false,-1.0
2,1,0.5,0.5,true,false,250,250,250,250,0,0,0,true,true,true,-1.0
2,1,0.5,0.5,true,false,250,300,247,297,-3,-3,3,true,true,true,-1.0
2,1,0.5,0.5,true,false,200,250,249,799,49,549,1,true,true,true,-1.0
2,1,0.5,0.5,true,false,300,350,297,347,-3,-3,3,true,true,true,-1.0
2,1,0.5,0.5,true,false,850,300,899,799,49,499,1,true,true,true,-1.0
2,1,0.5,0.5,true,false,300,250,349,799,49,549,1,true,true,true,-1.0
2,1,0.5,0.5,true,false,250,250,797,297,547,47,3,true,true,true,-1.0
2,1,0.5,0.5,true,false,300,200,947,247,647,47,3,true,true,true,-1.0
2,1,0.5,0.5,true,false,200,250,200,250,0,0,0,true,true,true,-1.0
2,1,0.5,0.5,true,false,850,300,849,299,-1,-1,1,true,true,true,-1.0
2,1,0.5,0.5,true,false,300,300,297,297,-3,-3,3,true,true,true,-1.0
2,1,0.5,0.5,false,false,250,250,797,347,547,97,3,true,true,true,154.364
2,1,0.5,0.5,false,false,200,850,197,847,-3,-3,3,true,true,true,-1.0
2,1,0.5,0.5,false,false,250,850,239,839,-11,-11,11,true,true,true,-1.0
2,1,0.5,0.5,false,false,250,850,249,849,-1,-1,1,true,true,true,-1.0
2,1,0.5,0.5,false,false,300,300,799,899,499,599,1,true,true,true,-1.0
2,1,0.5,0.5,false,false,250,250,250,250,0,0,0,true,true,true,-1.0
2,1,0.5,0.5,false,false,250,250,247,247,-3,-3,3,true,true,true,-1.0
2,1,0.5,0.5,false,false,350,250,378,778,28,528,22,true,true,true,-1.0
2,1,0.5,0.5,false,false,250,250,250,250,0,0,0,true,true,true,-1.0
2,1,0.5,0.5,false,false,250,850,247,847,-3,-3,3,true,true,true,-1.0
2,1,0.5,0.5,false,false,350,300,350,300,0,0,0,true,true,true,-1.0
2,1,0.5,0.5,false,false,850,200,847,197,-3,-3,3,true,true,true,-1.0
2,1,0.5,0.5,false,false,200,850,199,849,-1,-1,1,true,true,true,-1.0
2,1,0.5,0.5,false,false,850,850,849,849,-1,-1,1,true,true,true,-1.0
2,1,0.5,0.5,false,false,250,250,280,780,30,530,20,true,true,true,-1.0
2,1,0.5,0.5,false,false,200,850,199,849,-1,-1,1,true,true,true,-1.0
2,1,0.5,0.5,false,false,350,300,347,297,-3,-3,3,true,true,true,-1.0
2,1,0.5,0.5,false,false,850,200,899,249,49,49,1,true,true,true,-1.0
2,1,0.5,0.5,false,false,850,200,899,299,49,99,1,true,true,true,-1.0
2,1,0.5,0.5,false,false,300,300,349,799,49,499,1,true,true,true,-1.0
2,2,0.5,0.5,true,true,250,350,249,349,-1,-1,1,true,true,true,841.416
2,2,0.5,0.5,true,true,300,200,300,200,0,0,0,true,true,true,-1.0
2,2,0.5,0.5,true,true,850,250,850,250,0,0,0,true,true,true,-1.0
2,2,0.5,0.5,true,true,300,300,799,349,499,49,1,true,true,true,-1.0
2,2,0.5,0.5,true,true,250,200,200,150,-50,-50,50,false,false,false,-1.0
2,2,0.5,0.5,true,true,300,300,299,299,-1,-1,1,true,true,true,-1.0
2,2,0.5,0.5,true,true,300,250,347,797,47,547,3,true,true,true,-1.0
2,2,0.5,0.5,true,true,900,350,900,350,0,0,0,true,true,true,-1.0
2,2,0.5,0.5,true,true,250,250,298,798,48,548,2,true,true,true,-1.0
2,2,0.5,0.5,true,true,300,850,299,849,-1,-1,1,true,true,true,-1.0
2,2,0.5,0.5,true,true,250,300,298,798,48,498,2,true,true,true,-1.0
2,2,0.5,0.5,true,true,300,850,299,849,-1,-1,1,true,true,true,-1.0
2,2,0.5,0.5,true,true,200,900,199,899,-1,-1,1,true,true,true,-1.0
2,2,0.5,0.5,true,true,250,250,348,298,98,48,2,true,true,true,-1.0
2,2,0.5,0.5,true,true,300,200,349,299,49,99,1,true,true,true,-1.0
2,2,0.5,0.5,true,true,850,850,849,849,-1,-1,1,true,true,true,-1.0
2,2,0.5,0.5,true,true,300,200,299,199,-1,-1,1,true,true,true,-1.0
2,2,0.5,0.5,true,true,850,200,850,200,0,0,0,true,true,true,-1.0
2,2,0.5,0.5,true,true,300,200,299,199,-1,-1,1,true,true,true,-1.0
2,2,0.5,0.5,true,true,350,850,350,850,0,0,0,true,true,true,-1.0
2,2,0.5,0.5,true,false,300,850,300,850,0,0,0,true,true,true,385.324
2,2,0.5,0.5,true,false,200,200,198,198,-2,-2,2,true,true,true,-1.0
2,2,0.5,0.5,true,false,300,200,799,249,499,49,1,true,true,true,-1.0
2,2,0.5,0.5,true,false,850,300,899,799,49,499,1,true,true,true,-1.0
2,2,0.5,0.5,true,false,350,850,349,849,-1,-1,1,true,true,true,-1.0
2,2,0.5,0.5,true,false,850,300,849,299,-1,-1,1,true,true,true,-1.0
2,2,0.5,0.5,true,false,200,850,248,898,48,48,2,true,true,true,-1.0
2,2,0.5,0.5,true,false,300,200,300,200,0,0,0,true,true,true,-1.0
2,2,0.5,0.5,true,false,250,300,250,300,0,0,0,true,true,true,-1.0
2,2,0.5,0.5,true,false,300,250,299,249,-1,-1,1,true,true,true,-1.0
2,2,0.5,0.5,true,false,250,250,249,249,-1,-1,1,true,true,true,-1.0
2,2,0.5,0.5,true,false,350,850,349,849,-1,-1,1,true,true,true,-1.0
2,2,0.5,0.5,true,false,250,300,298,898,48,598,2,true,true,true,-1.0
2,2,0.5,0.5,true,false,200,300,348,798,148,498,2,true,true,true,-1.0
2,2,0.5,0.5,true,false,200,250,298,848,98,598,2,true,true,true,-1.0
2,2,0.5,0.5,true,false,200,850,197,847,-3,-3,3,true,true,true,-1.0
2,2,0.5,0.5,true,false,300,300,349,799,49,499,1,true,true,true,-1.0
2,2,0.5,0.5,true,false,850,200,847,247,-3,47,3,true,true,true,-1.0
2,2,0.5,0.5,true,false,300,250,299,249,-1,-1,1,true,true,true,-1.0
2,2,0.5,0.5,true,false,300,250,799,299,499,49,1,true,false,true,-1.0
2,2,0.5,0.5,false,true,200,250,198,248,-2,-2,2,true,true,true,162.572
2,2,0.5,0.5,false,true,250,350,248,348,-2,-2,2,true,true,true,-1.0
2,2,0.5,0.5,false,true,200,250,798,348,598,98,2,true,true,true,-1.0
2,2,0.5,0.5,false,true,850,250,849,249,-1,-1,1,true,true,true,-1.0
2,2,0.5,0.5,false,true,250,200,248,198,-2,-2,2,true,true,true,-1.0
2,2,0.5,0.5,false,true,250,850,250,850,0,0,0,true,true,true,-1.0
2,2,0.5,0.5,false,true,250,200,247,197,-3,-3,3,true,true,true,-1.0
2,2,0.5,0.5,false,true,850,200,899,249,49,49,1,true,true,true,-1.0
2,2,0.5,0.5,false,true,200,250,199,249,-1,-1,1,true,true,true,-1.0
2,2,0.5,0.5,false,true,250,300,348,798,98,498,2,true,true,true,-1.0
2,2,0.5,0.5,false,true,200,200,198,198,-2,-2,2,true,true,true,-1.0
2,2,0.5,0.5,false,true,350,200,349,199,-1,-1,1,true,true,true,-1.0
2,2,0.5,0.5,false,true,300,200,300,200,0,0,0,true,true,true,-1.0
2,2,0.5,0.5,false,true,850,300,849,299,-1,-1,1,true,true,true,-1.0
2,2,0.5,0.5,false,true,250,350,299,399,49,49,1,true,true,true,-1.0
2,2,0.5,0.5,false,true,300,250,298,248,-2,-2,2,true,true,true,-1.0
2,2,0.5,0.5,false,true,250,850,249,849,-1,-1,1,true,true,true,-1.0
2,2,0.5,0.5,false,true,850,300,849,299,-1,-1,1,true,true,true,-1.0
2,2,0.5,0.5,false,true,300,300,348,798,48,498,2,true,true,true,-1.0
2,2,0.5,0.5,false,true,200,350,198,348,-2,-2,2,true,true,true,-1.0
2,2,0.5,0.5,false,false,300,850,299,849,-1,-1,1,true,true,true,105.984
2,2,0.5,0.5,false,false,250,250,250,250,0,0,0,true,true,true,-1.0
2,2,0.5,0.5,false,false,900,200,899,199,-1,-1,1,true,true,true,-1.0
2,2,0.5,0.5,false,false,300,200,300,200,0,0,0,true,true,true,-1.0
2,2,0.5,0.5,false,false,250,300,298,348,48,48,2,true,true,true,-1.0
2,2,0.5,0.5,false,false,350,850,349,849,-1,-1,1,true,true,true,-1.0
2,2,0.5,0.5,false,false,300,850,299,849,-1,-1,1,true,true,true,-1.0
2,2,0.5,0.5,false,false,250,200,249,199,-1,-1,1,true,true,true,-1.0
2,2,0.5,0.5,false,false,300,350,299,349,-1,-1,1,true,true,true,-1.0
2,2,0.5,0.5,false,false,850,850,849,849,-1,-1,1,true,true,true,-1.0
2,2,0.5,0.5,false,false,250,300,249,299,-1,-1,1,true,true,true,-1.0
2,2,0.5,0.5,false,false,250,850,248,848,-2,-2,2,true,true,true,-1.0
2,2,0.5,0.5,false,false,850,300,849,299,-1,-1,1,true,true,true,-1.0
2,2,0.5,0.5,false,false,300,300,299,299,-1,-1,1,true,true,true,-1.0
2,2,0.5,0.5,false,false,350,200,399,249,49,49,1,true,true,true,-1.0
2,2,0.5,0.5,false,false,200,200,200,200,0,0,0,true,true,true,-1.0
2,2,0.5,0.5,false,false,300,250,798,298,498,48,2,true,true,true,-1.0
2,2,0.5,0.5,false,false,300,300,300,300,0,0,0,true,true,true,-1.0
2,2,0.5,0.5,false,false,250,300,871,321,621,21,29,true,true,true,-1.0
2,2,0.5,0.5,false,false,300,300,298,298,-2,-2,2,true,true,true,-1.0
0,0,0.5,0.5,false,false,200,250,248,798,48,548,2,true,true,true,0.189
0,0,0.5,0.5,false,false,200,300,248,798,48,498,2,true,true,true,-1.0
0,0,0.5,0.5,false,false,200,300,248,798,48,498,2,true,true,true,-1.0
0,0,0.5,0.5,false,false,250,300,247,297,-3,-3,3,true,true,true,-1.0
0,0,0.5,0.5,false,false,300,850,797,897,497,47,3,true,true,true,-1.0
0,0,0.5,0.5,false,false,200,300,197,297,-3,-3,3,true,true,true,-1.0
0,0,0.5,0.5,false,false,250,200,247,197,-3,-3,3,true,true,true,-1.0
0,0,0.5,0.5,false,false,850,250,896,796,46,546,4,true,true,true,-1.0
0,0,0.5,0.5,false,false,250,200,246,196,-4,-4,4,false,false,false,-1.0
0,0,0.5,0.5,false,false,300,250,348,798,48,548,2,true,true,true,-1.0
0,0,0.5,0.5,false,false,350,250,346,246,-4,-4,4,true,true,true,-1.0
0,0,0.5,0.5,false,false,850,250,898,798,48,548,2,true,true,true,-1.0
0,0,0.5,0.5,false,false,300,300,797,347,497,47,3,true,true,true,-1.0
0,0,0.5,0.5,false,false,900,200,897,197,-3,-3,3,true,true,true,-1.0
0,0,0.5,0.5,false,false,850,350,846,346,-4,-4,4,true,true,true,-1.0
0,0,0.5,0.5,false,false,200,300,197,297,-3,-3,3,false,false,false,-1.0
0,0,0.5,0.5,false,false,350,850,347,847,-3,-3,3,true,true,true,-1.0
0,0,0.5,0.5,false,false,250,250,248,248,-2,-2,2,true,true,true,-1.0
0,0,0.5,0.5,false,false,850,250,848,248,-2,-2,2,false,false,false,-1.0
0,0,0.5,0.5,false,false,300,300,898,798,598,498,2,true,true,true,-1.0
0,1,0.5,0.5,false,false,850,850,848,848,-2,-2,2,true,true,true,0.28
0,1,0.5,0.5,false,false,300,250,299,249,-1,-1,1,true,true,true,-1.0
0,1,0.5,0.5,false,false,300,200,897,297,597,97,3,true,true,true,-1.0
0,1,0.5,0.5,false,false,900,850,898,848,-2,-2,2,true,true,true,-1.0
0,1,0.5,0.5,false,false,300,300,948,798,648,498,2,true,true,true,-1.0
0,1,0.5,0.5,false,false,200,300,248,898,48,598,2,true,true,true,-1.0
0,1,0.5,0.5,false,false,250,350,249,349,-1,-1,1,true,true,true,-1.0
0,1,0.5,0.5,false,false,200,200,199,199,-1,-1,1,true,true,true,-1.0
0,1,0.5,0.5,false,false,350,200,899,249,549,49,1,true,true,true,-1.0
0,1,0.5,0.5,false,false,850,250,846,246,-4,-4,4,true,true,true,-1.0
0,1,0.5,0.5,false,false,200,250,798,348,598,98,2,true,true,true,-1.0
0,1,0.5,0.5,false,false,300,350,299,349,-1,-1,1,true,true,true,-1.0
0,1,0.5,0.5,false,false,250,250,246,246,-4,-4,4,true,true,true,-1.0
0,1,0.5,0.5,false,false,200,850,248,898,48,48,2,true,true,true,-1.0
0,1,0.5,0.5,false,false,200,250,196,246,-4,-4,4,true,true,true,-1.0
0,1,0.5,0.5,false,false,200,250,348,798,148,548,2,true,true,true,-1.0
0,1,0.5,0.5,false,false,850,300,898,798,48,498,2,true,true,true,-1.0
0,1,0.5,0.5,false,false,250,250,246,246,-4,-4,4,true,true,true,-1.0
0,1,0.5,0.5,false,false,250,250,247,247,-3,-3,3,true,true,true,-1.0
0,1,0.5,0.5,false,false,300,250,346,296,46,46,4,true,true,true,-1.0
0,2,0.5,0.5,false,true,300,850,299,849,-1,-1,1,true,true,true,316.439
0,2,0.5,0.5,false,true,250,200,298,798,48,598,2,true,false,true,-1.0
0,2,0.5,0.5,false,true,300,250,296,246,-4,-4,4,false,false,false,-1.0
0,2,0.5,0.5,false,true,850,250,846,246,-4,-4,4,true,true,true,-1.0
0,2,0.5,0.5,false,true,350,300,949,799,599,499,1,true,true,true,-1.0
0,2,0.5,0.5,false,true,250,250,249,249,-1,-1,1,true,true,true,-1.0
0,2,0.5,0.5,false,true,900,200,896,196,-4,-4,4,true,true,true,-1.0
0,2,0.5,0.5,false,true,250,250,348,798,98,548,2,true,true,true,-1.0
0,2,0.5,0.5,false,true,250,350,298,898,48,548,2,false,false,true,-1.0
0,2,0.5,0.5,false,true,900,300,948,798,48,498,2,true,true,true,-1.0
0,2,0.5,0.5,false,true,850,250,846,246,-4,-4,4,true,true,true,-1.0
0,2,0.5,0.5,false,true,250,200,298,798,48,598,2,true,true,true,-1.0
0,2,0.5,0.5,false,true,850,300,898,798,48,498,2,true,true,true,-1.0
0,2,0.5,0.5,false,true,200,300,248,348,48,48,2,true,true,true,-1.0
0,2,0.5,0.5,false,true,300,300,348,798,48,498,2,true,true,true,-1.0
0,2,0.5,0.5,false,true,300,300,799,349,499,49,1,true,true,true,-1.0
0,2,0.5,0.5,false,true,250,900,249,899,-1,-1,1,true,true,true,-1.0
0,2,0.5,0.5,false,true,200,300,199,299,-1,-1,1,true,true,true,-1.0
0,2,0.5,0.5,false,true,300,300,348,898,48,598,2,true,true,true,-1.0
0,2,0.5,0.5,false,true,300,250,799,299,499,49,1,true,true,true,-1.0
0,2,0.5,0.5,false,false,300,350,296,346,-4,-4,4,true,true,true,57.615
0,2,0.5,0.5,false,false,300,250,799,399,499,149,1,true,true,true,-1.0
0,2,0.5,0.5,false,false,300,850,296,846,-4,-4,4,true,true,true,-1.0
0,2,0.5,0.5,false,false,850,300,849,299,-1,-1,1,true,true,true,-1.0
0,2,0.5,0.5,false,false,300,250,296,246,-4,-4,4,true,true,true,-1.0
0,2,0.5,0.5,false,false,200,250,196,246,-4,-4,4,true,true,true,-1.0
0,2,0.5,0.5,false,false,300,850,296,846,-4,-4,4,true,true,true,-1.0
0,2,0.5,0.5,false,false,300,250,296,246,-4,-4,4,true,true,true,-1.0
0,2,0.5,0.5,false,false,250,350,246,346,-4,-4,4,true,true,true,-1.0
0,2,0.5,0.5,false,false,250,850,246,846,-4,-4,4,true,true,true,-1.0
0,2,0.5,0.5,false,false,200,250,248,848,48,598,2,false,false,true,-1.0
0,2,0.5,0.5,false,false,200,300,248,798,48,498,2,true,true,true,-1.0
0,2,0.5,0.5,false,false,200,250,349,799,149,549,1,true,true,true,-1.0
0,2,0.5,0.5,false,false,200,300,298,898,98,598,2,true,true,true,-1.0
0,2,0.5,0.5,false,false,300,900,299,899,-1,-1,1,true,true,true,-1.0
0,2,0.5,0.5,false,false,850,300,848,298,-2,-2,2,true,true,true,-1.0
0,2,0.5,0.5,false,false,300,200,797,397,497,197,3,true,true,true,-1.0
0,2,0.5,0.5,false,false,200,200,199,199,-1,-1,1,true,true,true,-1.0
0,2,0.5,0.5,false,false,200,300,196,296,-4,-4,4,true,true,true,-1.0
0,2,0.5,0.5,false,false,300,200,799,899,499,699,1,true,true,true,-1.0
1,0,0.5,0.5,false,false,850,300,845,295,-5,-5,5,true,true,true,0.333
1,0,0.5,0.5,false,false,200,300,797,347,597,47,3,true,true,true,-1.0
1,0,0.5,0.5,false,false,850,300,850,300,0,0,0,true,true,true,-1.0
1,0,0.5,0.5,false,false,200,300,249,399,49,99,1,true,false,true,-1.0
1,0,0.5,0.5,false,false,200,200,200,200,0,0,0,false,false,false,-1.0
1,0,0.5,0.5,false,false,300,850,797,897,497,47,3,true,true,true,-1.0
1,0,0.5,0.5,false,false,250,850,247,847,-3,-3,3,true,true,true,-1.0
1,0,0.5,0.5,false,false,250,850,247,847,-3,-3,3,true,true,true,-1.0
1,0,0.5,0.5,false,false,850,300,850,300,0,0,0,true,true,true,-1.0
1,0,0.5,0.5,false,false,850,200,850,200,0,0,0,true,true,true,-1.0
1,0,0.5,0.5,false,false,350,350,347,347,-3,-3,3,true,true,true,-1.0
1,0,0.5,0.5,false,false,300,250,300,250,0,0,0,true,true,true,-1.0
1,0,0.5,0.5,false,false,850,850,847,847,-3,-3,3,true,true,true,-1.0
1,0,0.5,0.5,false,false,250,300,250,300,0,0,0,true,true,true,-1.0
1,0,0.5,0.5,false,false,250,850,245,845,-5,-5,5,true,true,true,-1.0
1,0,0.5,0.5,false,false,850,350,847,347,-3,-3,3,true,true,true,-1.0
1,0,0.5,0.5,false,false,200,250,797,297,597,47,3,true,false,true,-1.0
1,0,0.5,0.5,false,false,200,250,298,798,98,548,2,true,true,true,-1.0
1,0,0.5,0.5,false,false,350,300,346,296,-4,-4,4,true,true,true,-1.0
1,0,0.5,0.5,false,false,200,200,799,249,599,49,1,true,true,true,-1.0
1,1,0.5,0.5,false,false,250,200,250,200,0,0,0,true,true,true,1.33
1,1,0.5,0.5,false,false,200,250,799,299,599,49,1,true,true,true,-1.0
1,1,0.5,0.5,false,false,200,300,797,347,597,47,3,true,true,true,-1.0
1,1,0.5,0.5,false,false,300,300,348,898,48,598,2,true,true,true,-1.0
1,1,0.5,0.5,false,false,200,900,197,897,-3,-3,3,true,true,true,-1.0
1,1,0.5,0.5,false,false,250,300,949,799,699,499,1,true,true,true,-1.0
1,1,0.5,0.5,false,false,250,850,799,899,549,49,1,true,true,true,-1.0
1,1,0.5,0.5,false,false,850,300,800,250,-50,-50,50,true,true,true,-1.0
1,1,0.5,0.5,false,false,250,200,299,249,49,49,1,true,true,true,-1.0
1,1,0.5,0.5,false,false,900,900,900,900,0,0,0,true,true,true,-1.0
1,1,0.5,0.5,false,false,200,850,197,847,-3,-3,3,true,true,true,-1.0
1,1,0.5,0.5,false,false,200,200,200,200,0,0,0,true,true,true,-1.0
1,1,0.5,0.5,false,false,250,300,899,899,649,599,1,true,true,true,-1.0
1,1,0.5,0.5,false,false,900,350,900,350,0,0,0,true,true,true,-1.0
1,1,0.5,0.5,false,false,850,850,850,850,0,0,0,true,true,true,-1.0
1,1,0.5,0.5,false,false,350,250,350,250,0,0,0,true,true,true,-1.0
1,1,0.5,0.5,false,false,200,250,246,296,46,46,4,true,true,true,-1.0
1,1,0.5,0.5,false,false,850,250,800,200,-50,-50,50,false,false,false,-1.0
1,1,0.5,0.5,false,false,850,300,800,250,-50,-50,50,true,true,true,-1.0
1,1,0.5,0.5,false,false,850,850,850,850,0,0,0,true,true,true,-1.0
1,2,0.5,0.5,false,true,300,300,348,898,48,598,2,true,true,true,445.215
1,2,0.5,0.5,false,true,250,350,248,348,-2,-2,2,true,true,true,-1.0
1,2,0.5,0.5,false,true,300,200,899,849,599,649,1,true,true,true,-1.0
1,2,0.5,0.5,false,true,250,350,297,397,47,47,3,true,true,true,-1.0
1,2,0.5,0.5,false,true,300,200,250,150,-50,-50,50,false,false,false,-1.0
1,2,0.5,0.5,false,true,300,200,798,348,498,148,2,true,true,true,-1.0
1,2,0.5,0.5,false,true,850,200,899,249,49,49,1,true,true,true,-1.0
1,2,0.5,0.5,false,true,900,300,900,300,0,0,0,true,true,true,-1.0
1,2,0.5,0.5,false,true,300,250,300,250,0,0,0,true,true,true,-1.0
1,2,0.5,0.5,false,true,350,850,349,849,-1,-1,1,true,true,true,-1.0
1,2,0.5,0.5,false,true,300,200,799,349,499,149,1,true,true,true,-1.0
1,2,0.5,0.5,false,true,250,250,248,248,-2,-2,2,true,true,true,-1.0
1,2,0.5,0.5,false,true,900,250,900,250,0,0,0,true,true,true,-1.0
1,2,0.5,0.5,false,true,250,200,250,200,0,0,0,true,true,true,-1.0
1,2,0.5,0.5,false,true,300,250,300,250,0,0,0,true,true,true,-1.0
1,2,0.5,0.5,false,true,200,300,299,949,99,649,1,true,true,true,-1.0
1,2,0.5,0.5,false,true,250,850,799,899,549,49,1,true,true,true,-1.0
1,2,0.5,0.5,false,true,250,300,798,348,548,48,2,true,true,true,-1.0
1,2,0.5,0.5,false,true,200,300,249,799,49,499,1,true,true,true,-1.0
1,2,0.5,0.5,false,true,300,350,298,348,-2,-2,2,true,true,true,-1.0
1,2,0.5,0.5,false,false,250,200,349,799,99,599,1,true,true,true,129.751
1,2,0.5,0.5,false,false,250,300,848,898,598,598,2,true,true,true,-1.0
1,2,0.5,0.5,false,false,850,300,898,798,48,498,2,true,true,true,-1.0
1,2,0.5,0.5,false,false,300,350,298,348,-2,-2,2,true,true,true,-1.0
1,2,0.5,0.5,false,false,250,850,248,848,-2,-2,2,true,true,true,-1.0
1,2,0.5,0.5,false,false,200,250,200,250,0,0,0,true,true,true,-1.0
1,2,0.5,0.5,false,false,200,200,200,200,0,0,0,true,true,true,-1.0
1,2,0.5,0.5,false,false,250,200,349,799,99,599,1,true,true,true,-1.0
1,2,0.5,0.5,false,false,250,850,799,899,549,49,1,true,true,true,-1.0
1,2,0.5,0.5,false,false,250,200,848,848,598,648,2,true,true,true,-1.0
1,2,0.5,0.5,false,false,250,250,799,899,549,649,1,true,true,true,-1.0
1,2,0.5,0.5,false,false,250,200,250,200,0,0,0,true,true,true,-1.0
1,2,0.5,0.5,false,false,250,300,250,300,0,0,0,true,true,true,-1.0
1,2,0.5,0.5,false,false,300,250,250,200,-50,-50,50,false,false,false,-1.0
1,2,0.5,0.5,false,false,200,900,199,899,-1,-1,1,true,true,true,-1.0
1,2,0.5,0.5,false,false,850,300,848,298,-2,-2,2,true,true,true,-1.0
1,2,0.5,0.5,false,false,300,250,294,244,-6,-6,6,true,true,true,-1.0
1,2,0.5,0.5,false,false,300,900,298,898,-2,-2,2,true,true,true,-1.0
1,2,0.5,0.5,false,false,850,250,899,799,49,549,1,true,true,true,-1.0
1,2,0.5,0.5,false,false,250,300,248,298,-2,-2,2,true,true,true,-1.0
2,0,0.5,0.5,true,false,300,350,797,397,497,47,3,true,true,true,572.942
2,0,0.5,0.5,true,false,200,300,249,799,49,499,1,true,true,true,-1.0
2,0,0.5,0.5,true,false,850,300,847,297,-3,-3,3,true,true,true,-1.0
2,0,0.5,0.5,true,false,900,250,895,245,-5,-5,5,false,false,false,-1.0
2,0,0.5,0.5,true,false,850,350,850,350,0,0,0,true,true,true,-1.0
2,0,0.5,0.5,true,false,850,250,899,799,49,549,1,true,true,true,-1.0
2,0,0.5,0.5,true,false,300,850,297,847,-3,-3,3,true,true,true,-1.0
2,0,0.5,0.5,true,false,250,900,247,897,-3,-3,3,true,true,true,-1.0
2,0,0.5,0.5,true,false,250,200,949,799,699,599,1,true,true,true,-1.0
2,0,0.5,0.5,true,false,300,250,347,297,47,47,3,true,true,true,-1.0
2,0,0.5,0.5,true,false,850,300,850,300,0,0,0,true,true,true,-1.0
2,0,0.5,0.5,true,false,300,200,898,798,598,598,2,true,true,true,-1.0
2,0,0.5,0.5,true,false,300,850,297,847,-3,-3,3,true,true,true,-1.0
2,0,0.5,0.5,true,false,250,300,247,297,-3,-3,3,true,true,true,-1.0
2,0,0.5,0.5,true,false,850,300,848,298,-2,-2,2,true,true,true,-1.0
2,0,0.5,0.5,true,false,200,300,248,798,48,498,2,true,true,true,-1.0
2,0,0.5,0.5,true,false,850,850,847,847,-3,-3,3,true,true,true,-1.0
2,0,0.5,0.5,true,false,300,250,300,250,0,0,0,true,true,true,-1.0
2,0,0.5,0.5,true,false,250,200,847,347,597,147,3,true,false,true,-1.0
2,0,0.5,0.5,true,false,850,850,847,847,-3,-3,3,true,true,true,-1.0
2,0,0.5,0.5,false,false,200,300,296,796,96,496,4,true,true,true,100.636
2,0,0.5,0.5,false,false,200,350,195,345,-5,-5,5,false,false,false,-1.0
2,0,0.5,0.5,false,false,850,250,845,245,-5,-5,5,true,true,true,-1.0
2,0,0.5,0.5,false,false,300,300,300,300,0,0,0,true,true,true,-1.0
2,0,0.5,0.5,false,false,200,300,197,297,-3,-3,3,true,true,true,-1.0
2,0,0.5,0.5,false,false,200,850,197,847,-3,-3,3,true,true,true,-1.0
2,0,0.5,0.5,false,false,900,200,900,200,0,0,0,true,true,true,-1.0
2,0,0.5,0.5,false,false,850,850,847,847,-3,-3,3,true,true,true,-1.0
2,0,0.5,0.5,false,false,250,300,247,297,-3,-3,3,true,true,true,-1.0
2,0,0.5,0.5,false,false,300,900,797,947,497,47,3,true,true,true,-1.0
2,0,0.5,0.5,false,false,250,250,245,245,-5,-5,5,true,true,true,-1.0
2,0,0.5,0.5,false,false,250,300,348,798,98,498,2,true,true,true,-1.0
2,0,0.5,0.5,false,false,300,300,295,295,-5,-5,5,true,true,true,-1.0
2,0,0.5,0.5,false,false,200,250,195,245,-5,-5,5,true,true,true,-1.0
2,0,0.5,0.5,false,false,200,300,197,297,-3,-3,3,true,true,true,-1.0
2,0,0.5,0.5,false,false,200,250,299,299,99,49,1,true,true,true,-1.0
2,0,0.5,0.5,false,false,200,200,200,200,0,0,0,true,true,true,-1.0
2,0,0.5,0.5,false,false,300,200,300,200,0,0,0,true,true,true,-1.0
2,0,0.5,0.5,false,false,300,850,297,847,-3,-3,3,true,true,true,-1.0
2,0,0.5,0.5,false,false,900,200,900,200,0,0,0,true,true,true,-1.0
2,1,0.5,0.5,true,false,850,250,850,250,0,0,0,true,true,true,1146.003
2,1,0.5,0.5,true,false,300,300,299,299,-1,-1,1,true,true,true,-1.0
2,1,0.5,0.5,true,false,250,250,797,297,547,47,3,true,true,true,-1.0
2,1,0.5,0.5,true,false,850,250,899,299,49,49,1,true,true,true,-1.0
2,1,0.5,0.5,true,false,300,850,250,800,-50,-50,50,false,false,false,-1.0
2,1,0.5,0.5,true,false,300,200,300,200,0,0,0,true,true,true,-1.0
2,1,0.5,0.5,true,false,300,850,297,847,-3,-3,3,true,true,true,-1.0
2,1,0.5,0.5,true,false,300,250,297,247,-3,-3,3,true,true,true,-1.0
2,1,0.5,0.5,true,false,250,850,798,898,548,48,2,true,true,true,-1.0
2,1,0.5,0.5,true,false,300,200,847,847,547,647,3,true,true,true,-1.0
2,1,0.5,0.5,true,false,850,300,847,297,-3,-3,3,true,true,true,-1.0
2,1,0.5,0.5,true,false,250,850,250,850,0,0,0,true,true,true,-1.0
2,1,0.5,0.5,true,false,850,350,847,347,-3,-3,3,true,true,true,-1.0
2,1,0.5,0.5,true,false,300,850,297,847,-3,-3,3,true,true,true,-1.0
2,1,0.5,0.5,true,false,300,350,297,347,-3,-3,3,true,true,true,-1.0
2,1,0.5,0.5,true,false,300,200,798,798,498,598,2,true,true,true,-1.0
2,1,0.5,0.5,true,false,350,850,350,850,0,0,0,true,true,true,-1.0
2,1,0.5,0.5,true,false,200,850,197,847,-3,-3,3,true,true,true,-1.0
2,1,0.5,0.5,true,false,200,300,191,291,-9,-9,9,true,true,true,-1.0
2,1,0.5,0.5,true,false,300,300,297,297,-3,-3,3,true,true,true,-1.0
2,1,0.5,0.5,false,false,850,350,847,347,-3,-3,3,true,true,true,158.921
2,1,0.5,0.5,false,false,250,850,247,847,-3,-3,3,true,true,true,-1.0
2,1,0.5,0.5,false,false,300,250,847,847,547,597,3,true,true,true,-1.0
2,1,0.5,0.5,false,false,250,250,250,250,0,0,0,true,true,true,-1.0
2,1,0.5,0.5,false,false,300,300,297,297,-3,-3,3,true,true,true,-1.0
2,1,0.5,0.5,false,false,250,300,848,348,598,48,2,true,true,true,-1.0
2,1,0.5,0.5,false,false,300,350,297,347,-3,-3,3,true,true,true,-1.0
2,1,0.5,0.5,false,false,300,300,297,297,-3,-3,3,true,true,true,-1.0
2,1,0.5,0.5,false,false,300,850,798,898,498,48,2,true,true,true,-1.0
2,1,0.5,0.5,false,false,200,200,200,200,0,0,0,true,true,true,-1.0
2,1,0.5,0.5,false,false,250,250,798,348,548,98,2,true,true,true,-1.0
2,1,0.5,0.5,false,false,350,250,398,798,48,548,2,true,true,true,-1.0
2,1,0.5,0.5,false,false,250,850,250,850,0,0,0,true,true,true,-1.0
2,1,0.5,0.5,false,false,200,350,150,300,-50,-50,50,false,false,false,-1.0
2,1,0.5,0.5,false,false,250,250,247,247,-3,-3,3,true,true,true,-1.0
2,1,0.5,0.5,false,false,250,200,250,200,0,0,0,true,true,true,-1.0
2,1,0.5,0.5,false,false,900,250,900,250,0,0,0,true,true,true,-1.0
2,1,0.5,0.5,false,false,250,300,247,297,-3,-3,3,true,true,true,-1.0
2,1,0.5,0.5,false,false,250,300,798,348,548,48,2,true,true,true,-1.0
2,1,0.5,0.5,false,false,850,200,899,249,49,49,1,true,true,true,-1.0
2,2,0.5,0.5,true,true,850,850,849,849,-1,-1,1,true,true,true,616.576
2,2,0.5,0.5,true,true,250,250,248,248,-2,-2,2,true,true,true,-1.0
2,2,0.5,0.5,true,true,200,300,298,348,98,48,2,true,true,true,-1.0
2,2,0.5,0.5,true,true,200,300,299,349,99,49,1,true,true,true,-1.0
2,2,0.5,0.5,true,true,300,350,299,349,-1,-1,1,true,true,true,-1.0
2,2,0.5,0.5,true,true,250,200,250,200,0,0,0,true,true,true,-1.0
2,2,0.5,0.5,true,true,250,850,798,898,548,48,2,true,true,true,-1.0
2,2,0.5,0.5,true,true,300,200,300,200,0,0,0,true,true,true,-1.0
2,2,0.5,0.5,true,true,900,300,899,299,-1,-1,1,true,true,true,-1.0
2,2,0.5,0.5,true,true,200,250,200,250,0,0,0,true,true,true,-1.0
2,2,0.5,0.5,true,true,850,900,849,899,-1,-1,1,true,true,true,-1.0
2,2,0.5,0.5,true,true,200,300,199,299,-1,-1,1,true,true,true,-1.0
2,2,0.5,0.5,true,true,300,200,849,249,549,49,1,true,false,true,-1.0
2,2,0.5,0.5,true,true,350,850,349,849,-1,-1,1,true,true,true,-1.0
2,2,0.5,0.5,true,true,200,850,199,849,-1,-1,1,true,true,true,-1.0
2,2,0.5,0.5,true,true,350,300,350,300,0,0,0,true,true,true,-1.0
2,2,0.5,0.5,true,true,250,300,276,326,26,26,24,true,true,true,-1.0
2,2,0.5,0.5,true,true,200,200,248,298,48,98,2,true,true,true,-1.0
2,2,0.5,0.5,true,true,300,350,300,350,0,0,0,true,true,true,-1.0
2,2,0.5,0.5,true,true,850,200,899,799,49,599,1,true,true,true,-1.0
2,2,0.5,0.5,true,false,300,300,298,298,-2,-2,2,true,true,true,459.873
2,2,0.5,0.5,true,false,300,300,296,296,-4,-4,4,true,true,true,-1.0
2,2,0.5,0.5,true,false,250,250,249,249,-1,-1,1,true,true,true,-1.0
2,2,0.5,0.5,true,false,850,300,849,299,-1,-1,1,true,true,true,-1.0
2,2,0.5,0.5,true,false,850,200,850,200,0,0,0,true,true,true,-1.0
2,2,0.5,0.5,true,false,250,350,799,949,549,599,1,true,true,true,-1.0
2,2,0.5,0.5,true,false,300,300,789,339,489,39,11,true,true,true,-1.0
2,2,0.5,0.5,true,false,250,250,798,298,548,48,2,true,true,true,-1.0
2,2,0.5,0.5,true,false,300,350,299,349,-1,-1,1,true,true,true,-1.0
2,2,0.5,0.5,true,false,200,250,248,798,48,548,2,true,true,true,-1.0
2,2,0.5,0.5,true,false,850,200,848,198,-2,-2,2,true,true,true,-1.0
2,2,0.5,0.5,true,false,250,200,247,197,-3,-3,3,true,true,true,-1.0
2,2,0.5,0.5,true,false,300,350,898,898,598,548,2,true,true,true,-1.0
2,2,0.5,0.5,true,false,200,850,199,849,-1,-1,1,true,true,true,-1.0
2,2,0.5,0.5,true,false,300,850,299,849,-1,-1,1,true,true,true,-1.0
2,2,0.5,0.5,true,false,350,250,897,347,547,97,3,true,true,true,-1.0
2,2,0.5,0.5,true,false,350,300,350,300,0,0,0,true,true,true,-1.0
2,2,0.5,0.5,true,false,250,350,248,348,-2,-2,2,true,true,true,-1.0
2,2,0.5,0.5,true,false,250,200,250,200,0,0,0,true,true,true,-1.0
2,2,0.5,0.5,true,false,200,250,198,248,-2,-2,2,true,true,true,-1.0
2,2,0.5,0.5,false,true,300,250,849,899,549,649,1,true,true,true,213.205
2,2,0.5,0.5,false,true,350,300,349,299,-1,-1,1,true,true,true,-1.0
2,2,0.5,0.5,false,true,850,350,849,349,-1,-1,1,true,true,true,-1.0
2,2,0.5,0.5,false,true,300,250,349,299,49,49,1,true,true,true,-1.0
2,2,0.5,0.5,false,true,200,900,798,948,598,48,2,true,true,true,-1.0
2,2,0.5,0.5,false,true,300,300,299,299,-1,-1,1,true,true,true,-1.0
2,2,0.5,0.5,false,true,300,250,797,397,497,147,3,true,true,true,-1.0
2,2,0.5,0.5,false,true,250,350,298,898,48,548,2,true,false,true,-1.0
2,2,0.5,0.5,false,true,250,300,249,299,-1,-1,1,true,true,true,-1.0
2,2,0.5,0.5,false,true,350,300,350,300,0,0,0,true,true,true,-1.0
2,2,0.5,0.5,false,true,250,350,247,347,-3,-3,3,true,true,true,-1.0
2,2,0.5,0.5,false,true,300,250,346,346,46,96,4,true,false,true,-1.0
2,2,0.5,0.5,false,true,850,350,850,350,0,0,0,true,true,true,-1.0
2,2,0.5,0.5,false,true,250,200,797,897,547,697,3,true,true,true,-1.0
2,2,0.5,0.5,false,true,350,250,899,299,549,49,1,true,true,true,-1.0
2,2,0.5,0.5,false,true,200,900,248,948,48,48,2,true,true,true,-1.0
2,2,0.5,0.5,false,true,200,200,199,199,-1,-1,1,true,true,true,-1.0
2,2,0.5,0.5,false,true,250,300,348,798,98,498,2,true,true,true,-1.0
2,2,0.5,0.5,false,true,850,850,848,848,-2,-2,2,true,true,true,-1.0
2,2,0.5,0.5,false,true,250,250,249,249,-1,-1,1,true,true,true,-1.0
2,2,0.5,0.5,false,false,250,200,949,799,699,599,1,true,true,true,113.95
2,2,0.5,0.5,false,false,300,200,799,899,499,699,1,true,true,true,-1.0
2,2,0.5,0.5,false,false,300,250,799,299,499,49,1,true,true,true,-1.0
2,2,0.5,0.5,false,false,250,300,298,848,48,548,2,true,true,true,-1.0
2,2,0.5,0.5,false,false,250,200,250,200,0,0,0,true,true,true,-1.0
2,2,0.5,0.5,false,false,200,250,798,898,598,648,2,true,true,true,-1.0
2,2,0.5,0.5,false,false,300,250,396,796,96,546,4,true,true,true,-1.0
2,2,0.5,0.5,false,false,250,300,248,298,-2,-2,2,true,true,true,-1.0
2,2,0.5,0.5,false,false,200,300,248,798,48,498,2,true,true,true,-1.0
2,2,0.5,0.5,false,false,850,300,850,300,0,0,0,true,true,true,-1.0
2,2,0.5,0.5,false,false,250,850,799,899,549,49,1,true,true,true,-1.0
2,2,0.5,0.5,false,false,200,350,798,398,598,48,2,true,true,true,-1.0
2,2,0.5,0.5,false,false,300,200,299,199,-1,-1,1,true,true,true,-1.0
2,2,0.5,0.5,false,false,300,200,300,200,0,0,0,true,true,true,-1.0
2,2,0.5,0.5,false,false,200,300,248,798,48,498,2,true,true,true,-1.0
2,2,0.5,0.5,false,false,200,200,200,200,0,0,0,true,true,true,-1.0
2,2,0.5,0.5,false,false,200,300,248,798,48,498,2,true,true,true,-1.0
2,2,0.5,0.5,false,false,300,250,798,348,498,98,2,true,true,true,-1.0
2,2,0.5,0.5,false,false,250,250,797,297,547,47,3,true,true,true,-1.0
2,2,0.5,0.5,false,false,200,250,200,250,0,0,0,true,true,true,-1.0
0,0,0.5,0.5,false,false,300,300,348,798,48,498,2,true,true,true,0.226
0,0,0.5,0.5,false,false,350,200,346,196,-4,-4,4,true,true,true,-1.0
0,0,0.5,0.5,false,false,200,350,198,348,-2,-2,2,true,true,true,-1.0
0,0,0.5,0.5,false,false,250,200,797,247,547,47,3,true,true,true,-1.0
0,0,0.5,0.5,false,false,850,250,898,798,48,548,2,true,true,true,-1.0
0,0,0.5,0.5,false,false,900,250,897,247,-3,-3,3,false,false,false,-1.0
0,0,0.5,0.5,false,false,300,300,298,298,-2,-2,2,true,true,true,-1.0
0,0,0.5,0.5,false,false,250,850,296,896,46,46,4,true,true,true,-1.0
0,0,0.5,0.5,false,false,250,300,246,296,-4,-4,4,false,false,false,-1.0
0,0,0.5,0.5,false,false,300,300,799,899,499,599,1,true,true,true,-1.0
0,0,0.5,0.5,false,false,250,350,246,346,-4,-4,4,true,true,true,-1.0
0,0,0.5,0.5,false,false,300,250,797,297,497,47,3,true,true,true,-1.0
0,0,0.5,0.5,false,false,850,300,846,296,-4,-4,4,true,true,true,-1.0
0,0,0.5,0.5,false,false,350,850,347,847,-3,-3,3,true,true,true,-1.0
0,0,0.5,0.5,false,false,300,200,899,849,599,649,1,true,true,true,-1.0
0,0,0.5,0.5,false,false,250,300,797,347,547,47,3,true,true,true,-1.0
0,0,0.5,0.5,false,false,200,850,197,847,-3,-3,3,true,true,true,-1.0
0,0,0.5,0.5,false,false,250,350,799,399,549,49,1,true,true,true,-1.0
0,0,0.5,0.5,false,false,300,300,296,296,-4,-4,4,true,true,true,-1.0
0,0,0.5,0.5,false,false,300,850,799,899,499,49,1,true,true,true,-1.0
0,1,0.5,0.5,false,false,250,850,798,898,548,48,2,true,true,true,0.316
0,1,0.5,0.5,false,false,250,200,898,798,648,598,2,true,true,true,-1.0
0,1,0.5,0.5,false,false,300,300,898,798,598,498,2,true,true,true,-1.0
0,1,0.5,0.5,false,false,300,250,296,246,-4,-4,4,false,false,false,-1.0
0,1,0.5,0.5,false,false,250,300,249,299,-1,-1,1,true,true,true,-1.0
0,1,0.5,0.5,false,false,850,300,846,296,-4,-4,4,true,true,true,-1.0
0,1,0.5,0.5,false,false,200,200,348,798,148,598,2,true,true,true,-1.0
0,1,0.5,0.5,false,false,850,350,846,346,-4,-4,4,true,true,true,-1.0
0,1,0.5,0.5,false,false,300,300,797,397,497,97,3,true,true,true,-1.0
0,1,0.5,0.5,false,false,300,300,898,798,598,498,2,true,true,true,-1.0
0,1,0.5,0.5,false,false,250,300,246,296,-4,-4,4,true,true,true,-1.0
0,1,0.5,0.5,false,false,200,300,948,798,748,498,2,true,true,true,-1.0
0,1,0.5,0.5,false,false,300,300,899,799,599,499,1,true,true,true,-1.0
0,1,0.5,0.5,false,false,250,300,348,798,98,498,2,true,true,true,-1.0
0,1,0.5,0.5,false,false,300,200,296,196,-4,-4,4,true,true,true,-1.0
0,1,0.5,0.5,false,false,300,250,296,246,-4,-4,4,true,true,true,-1.0
0,1,0.5,0.5,false,false,300,250,348,798,48,548,2,true,true,true,-1.0
0,1,0.5,0.5,false,false,850,350,847,347,-3,-3,3,true,true,true,-1.0
0,1,0.5,0.5,false,false,250,300,247,297,-3,-3,3,true,true,true,-1.0
0,1,0.5,0.5,false,false,200,200,196,196,-4,-4,4,true,true,true,-1.0
0,2,0.5,0.5,false,true,250,850,797,897,547,47,3,true,true,true,434.235
0,2,0.5,0.5,false,true,200,200,848,898,648,698,2,true,true,true,-1.0
0,2,0.5,0.5,false,true,250,850,247,847,-3,-3,3,true,true,true,-1.0
0,2,0.5,0.5,false,true,250,250,948,798,698,548,2,true,true,true,-1.0
0,2,0.5,0.5,false,true,250,200,246,196,-4,-4,4,true,true,true,-1.0
0,2,0.5,0.5,false,true,250,250,298,348,48,98,2,true,true,true,-1.0
0,2,0.5,0.5,false,true,350,300,898,348,548,48,2,true,true,true,-1.0
0,2,0.5,0.5,false,true,300,300,398,798,98,498,2,true,true,true,-1.0
0,2,0.5,0.5,false,true,900,250,898,248,-2,-2,2,true,true,true,-1.0
0,2,0.5,0.5,false,true,200,850,248,898,48,48,2,true,true,true,-1.0
0,2,0.5,0.5,false,true,250,250,246,246,-4,-4,4,true,true,true,-1.0
0,2,0.5,0.5,false,true,250,300,348,798,98,498,2,true,true,true,-1.0
0,2,0.5,0.5,false,true,350,200,346,196,-4,-4,4,false,false,false,-1.0
0,2,0.5,0.5,false,true,200,300,799,899,599,599,1,true,true,true,-1.0
0,2,0.5,0.5,false,true,250,850,246,846,-4,-4,4,true,true,true,-1.0
0,2,0.5,0.5,false,true,300,200,348,798,48,598,2,true,true,true,-1.0
0,2,0.5,0.5,false,true,300,300,299,299,-1,-1,1,true,true,true,-1.0
0,2,0.5,0.5,false,true,200,300,248,798,48,498,2,false,false,true,-1.0
0,2,0.5,0.5,false,true,300,350,298,348,-2,-2,2,true,true,true,-1.0
0,2,0.5,0.5,false,true,300,250,296,246,-4,-4,4,true,true,true,-1.0
0,2,0.5,0.5,false,false,200,300,199,299,-1,-1,1,true,true,true,72.157
0,2,0.5,0.5,false,false,850,200,849,199,-1,-1,1,true,true,true,-1.0
0,2,0.5,0.5,false,false,300,300,298,298,-2,-2,2,true,true,true,-1.0
0,2,0.5,0.5,false,false,200,850,196,846,-4,-4,4,true,true,true,-1.0
0,2,0.5,0.5,false,false,200,250,799,349,599,99,1,true,true,true,-1.0
0,2,0.5,0.5,false,false,200,200,248,798,48,598,2,true,true,true,-1.0
0,2,0.5,0.5,false,false,850,250,846,246,-4,-4,4,true,true,true,-1.0
0,2,0.5,0.5,false,false,200,300,248,798,48,498,2,true,true,true,-1.0
0,2,0.5,0.5,false,false,350,850,348,848,-2,-2,2,true,true,true,-1.0
0,2,0.5,0.5,false,false,300,850,299,849,-1,-1,1,true,true,true,-1.0
0,2,0.5,0.5,false,false,900,300,896,296,-4,-4,4,true,true,true,-1.0
0,2,0.5,0.5,false,false,250,350,298,898,48,548,2,true,true,true,-1.0
0,2,0.5,0.5,false,false,350,300,346,296,-4,-4,4,true,true,true,-1.0
0,2,0.5,0.5,false,false,200,250,248,298,48,48,2,true,false,true,-1.0
0,2,0.5,0.5,false,false,350,300,346,296,-4,-4,4,true,true,true,-1.0
0,2,0.5,0.5,false,false,200,200,199,199,-1,-1,1,true,true,true,-1.0
0,2,0.5,0.5,false,false,300,200,799,249,499,49,1,true,true,true,-1.0
0,2,0.5,0.5,false,false,350,300,947,797,597,497,3,true,true,true,-1.0
0,2,0.5,0.5,false,false,350,250,346,246,-4,-4,4,true,true,true,-1.0
0,2,0.5,0.5,false,false,200,300,799,899,599,599,1,true,true,true,-1.0
1,0,0.5,0.5,false,false,250,250,247,247,-3,-3,3,true,true,true,0.304
1,0,0.5,0.5,false,false,300,300,300,300,0,0,0,true,true,true,-1.0
1,0,0.5,0.5,false,false,300,300,296,296,-4,-4,4,true,true,true,-1.0
1,0,0.5,0.5,false,false,350,250,350,250,0,0,0,true,true,true,-1.0
1,0,0.5,0.5,false,false,200,350,797,397,597,47,3,true,true,true,-1.0
1,0,0.5,0.5,false,false,250,300,348,798,98,498,2,true,true,true,-1.0
1,0,0.5,0.5,false,false,300,850,297,847,-3,-3,3,true,true,true,-1.0
1,0,0.5,0.5,false,false,300,250,297,247,-3,-3,3,true,true,true,-1.0
1,0,0.5,0.5,false,false,850,350,850,350,0,0,0,true,true,true,-1.0
1,0,0.5,0.5,false,false,250,250,299,799,49,549,1,true,false,true,-1.0
1,0,0.5,0.5,false,false,300,300,296,296,-4,-4,4,true,true,true,-1.0
1,0,0.5,0.5,false,false,300,850,799,899,499,49,1,true,true,true,-1.0
1,0,0.5,0.5,false,false,850,350,845,345,-5,-5,5,true,true,true,-1.0
1,0,0.5,0.5,false,false,850,850,847,847,-3,-3,3,true,true,true,-1.0
1,0,0.5,0.5,false,false,300,200,799,249,499,49,1,true,true,true,-1.0
1,0,0.5,0.5,false,false,250,200,299,299,49,99,1,true,false,true,-1.0
1,0,0.5,0.5,false,false,350,250,345,245,-5,-5,5,true,true,true,-1.0
1,0,0.5,0.5,false,false,350,300,897,347,547,47,3,true,true,true,-1.0
1,0,0.5,0.5,false,false,250,850,245,845,-5,-5,5,true,true,true,-1.0
1,0,0.5,0.5,false,false,300,300,799,899,499,599,1,true,true,true,-1.0
1,1,0.5,0.5,false,false,200,200,799,399,599,199,1,true,true,true,1.394
1,1,0.5,0.5,false,false,250,300,799,949,549,649,1,true,true,true,-1.0
1,1,0.5,0.5,false,false,200,200,197,197,-3,-3,3,true,true,true,-1.0
1,1,0.5,0.5,false,false,850,200,899,249,49,49,1,true,true,true,-1.0
1,1,0.5,0.5,false,false,300,350,799,949,499,599,1,true,true,true,-1.0
1,1,0.5,0.5,false,false,250,850,200,800,-50,-50,50,true,true,true,-1.0
1,1,0.5,0.5,false,false,250,200,200,150,-50,-50,50,false,false,false,-1.0
1,1,0.5,0.5,false,false,300,900,250,850,-50,-50,50,true,true,true,-1.0
1,1,0.5,0.5,false,false,300,850,297,847,-3,-3,3,true,true,true,-1.0
1,1,0.5,0.5,false,false,300,850,297,847,-3,-3,3,true,true,true,-1.0
1,1,0.5,0.5,false,false,350,300,300,250,-50,-50,50,true,true,true,-1.0
1,1,0.5,0.5,false,false,300,250,250,200,-50,-50,50,false,false,false,-1.0
1,1,0.5,0.5,false,false,200,300,150,250,-50,-50,50,false,false,false,-1.0
1,1,0.5,0.5,false,false,250,900,200,850,-50,-50,50,true,true,true,-1.0
1,1,0.5,0.5,false,false,300,300,300,300,0,0,0,true,true,true,-1.0
1,1,0.5,0.5,false,false,850,250,800,200,-50,-50,50,true,true,true,-1.0
1,1,0.5,0.5,false,false,200,300,799,349,599,49,1,true,true,true,-1.0
1,1,0.5,0.5,false,false,300,350,799,399,499,49,1,true,true,true,-1.0
1,1,0.5,0.5,false,false,300,300,848,898,548,598,2,true,true,true,-1.0
1,1,0.5,0.5,false,false,850,850,847,847,-3,-3,3,true,true,true,-1.0
1,2,0.5,0.5,false,true,200,300,799,899,599,599,1,true,true,true,666.326
1,2,0.5,0.5,false,true,300,250,799,899,499,649,1,true,true,true,-1.0
1,2,0.5,0.5,false,true,300,300,797,347,497,47,3,true,true,true,-1.0
1,2,0.5,0.5,false,true,300,250,250,200,-50,-50,50,false,false,false,-1.0
1,2,0.5,0.5,false,true,350,850,348,848,-2,-2,2,true,true,true,-1.0
1,2,0.5,0.5,false,true,250,200,799,299,549,99,1,true,true,true,-1.0
1,2,0.5,0.5,false,true,300,300,250,250,-50,-50,50,false,false,false,-1.0
1,2,0.5,0.5,false,true,300,250,300,250,0,0,0,true,true,true,-1.0
1,2,0.5,0.5,false,true,300,250,821,271,521,21,29,true,true,true,-1.0
1,2,0.5,0.5,false,true,300,300,298,298,-2,-2,2,true,true,true,-1.0
1,2,0.5,0.5,false,true,200,300,249,799,49,499,1,true,true,true,-1.0
1,2,0.5,0.5,false,true,300,300,298,298,-2,-2,2,true,true,true,-1.0
1,2,0.5,0.5,false,true,300,200,849,849,549,649,1,true,true,true,-1.0
1,2,0.5,0.5,false,true,350,850,348,848,-2,-2,2,true,true,true,-1.0
1,2,0.5,0.5,false,true,350,300,350,300,0,0,0,true,true,true,-1.0
1,2,0.5,0.5,false,true,300,300,799,899,499,599,1,true,true,true,-1.0
1,2,0.5,0.5,false,true,300,250,349,799,49,549,1,true,true,true,-1.0
1,2,0.5,0.5,false,true,900,300,896,296,-4,-4,4,true,true,true,-1.0
1,2,0.5,0.5,false,true,250,250,250,250,0,0,0,true,true,true,-1.0
1,2,0.5,0.5,false,true,300,850,298,848,-2,-2,2,true,true,true,-1.0
1,2,0.5,0.5,false,false,850,200,850,200,0,0,0,true,true,true,164.286
1,2,0.5,0.5,false,false,200,300,298,798,98,498,2,true,true,true,-1.0
1,2,0.5,0.5,false,false,300,300,899,349,599,49,1,true,true,true,-1.0
1,2,0.5,0.5,false,false,300,850,298,848,-2,-2,2,true,true,true,-1.0
1,2,0.5,0.5,false,false,250,900,248,898,-2,-2,2,true,true,true,-1.0
1,2,0.5,0.5,false,false,200,250,199,249,-1,-1,1,true,true,true,-1.0
1,2,0.5,0.5,false,false,300,200,849,299,549,99,1,true,true,true,-1.0
1,2,0.5,0.5,false,false,350,250,350,250,0,0,0,true,true,true,-1.0
1,2,0.5,0.5,false,false,300,200,300,200,0,0,0,false,false,false,-1.0
1,2,0.5,0.5,false,false,300,850,299,849,-1,-1,1,true,true,true,-1.0
1,2,0.5,0.5,false,false,250,200,250,200,0,0,0,false,false,false,-1.0
1,2,0.5,0.5,false,false,350,850,349,849,-1,-1,1,true,true,true,-1.0
1,2,0.5,0.5,false,false,850,350,846,346,-4,-4,4,true,true,true,-1.0
1,2,0.5,0.5,false,false,250,850,250,850,0,0,0,true,true,true,-1.0
1,2,0.5,0.5,false,false,850,850,850,850,0,0,0,true,true,true,-1.0
1,2,0.5,0.5,false,false,200,350,198,348,-2,-2,2,true,true,true,-1.0
1,2,0.5,0.5,false,false,850,300,848,298,-2,-2,2,true,true,true,-1.0
1,2,0.5,0.5,false,false,850,250,899,799,49,549,1,true,true,true,-1.0
1,2,0.5,0.5,false,false,300,200,799,349,499,149,1,true,true,true,-1.0
1,2,0.5,0.5,false,false,350,300,948,798,598,498,2,true,true,true,-1.0
2,0,0.5,0.5,true,false,200,200,197,197,-3,-3,3,true,true,true,659.093
2,0,0.5,0.5,true,false,300,200,349,799,49,599,1,true,true,true,-1.0
2,0,0.5,0.5,true,false,250,250,899,849,649,599,1,true,true,true,-1.0
2,0,0.5,0.5,true,false,350,250,397,797,47,547,3,true,true,true,-1.0
2,0,0.5,0.5,true,false,300,300,797,897,497,597,3,true,true,true,-1.0
2,0,0.5,0.5,true,false,850,250,899,799,49,549,1,true,true,true,-1.0
2,0,0.5,0.5,true,false,250,250,245,245,-5,-5,5,true,true,true,-1.0
2,0,0.5,0.5,true,false,900,250,895,245,-5,-5,5,true,true,true,-1.0
2,0,0.5,0.5,true,false,850,300,897,797,47,497,3,true,true,true,-1.0
2,0,0.5,0.5,true,false,300,850,297,847,-3,-3,3,true,true,true,-1.0
2,0,0.5,0.5,true,false,300,300,396,796,96,496,4,true,true,true,-1.0
2,0,0.5,0.5,true,false,850,350,850,350,0,0,0,true,true,true,-1.0
2,0,0.5,0.5,true,false,300,250,349,799,49,549,1,true,true,true,-1.0
2,0,0.5,0.5,true,false,250,900,247,897,-3,-3,3,true,true,true,-1.0
2,0,0.5,0.5,true,false,850,250,899,799,49,549,1,true,true,true,-1.0
2,0,0.5,0.5,true,false,350,200,347,197,-3,-3,3,true,true,true,-1.0
2,0,0.5,0.5,true,false,300,200,295,195,-5,-5,5,true,true,true,-1.0
2,0,0.5,0.5,true,false,300,300,797,347,497,47,3,true,true,true,-1.0
2,0,0.5,0.5,true,false,300,200,897,247,597,47,3,true,true,true,-1.0
2,0,0.5,0.5,true,false,250,300,849,849,599,549,1,true,true,true,-1.0
2,0,0.5,0.5,false,false,250,900,247,897,-3,-3,3,true,true,true,92.659
2,0,0.5,0.5,false,false,200,300,197,297,-3,-3,3,false,false,false,-1.0
2,0,0.5,0.5,false,false,250,200,898,798,648,598,2,true,true,true,-1.0
2,0,0.5,0.5,false,false,850,900,850,900,0,0,0,true,true,true,-1.0
2,0,0.5,0.5,false,false,300,200,847,297,547,97,3,true,true,true,-1.0
2,0,0.5,0.5,false,false,200,300,200,300,0,0,0,true,true,true,-1.0
2,0,0.5,0.5,false,false,250,300,247,297,-3,-3,3,true,true,true,-1.0
2,0,0.5,0.5,false,false,250,850,247,847,-3,-3,3,true,true,true,-1.0
2,0,0.5,0.5,false,false,300,850,297,847,-3,-3,3,true,true,true,-1.0
2,0,0.5,0.5,false,false,300,200,797,247,497,47,3,true,true,true,-1.0
2,0,0.5,0.5,false,false,300,900,796,946,496,46,4,true,true,true,-1.0
2,0,0.5,0.5,false,false,300,300,295,295,-5,-5,5,false,false,false,-1.0
2,0,0.5,0.5,false,false,200,250,200,250,0,0,0,true,true,true,-1.0
2,0,0.5,0.5,false,false,300,200,847,297,547,97,3,true,true,true,-1.0
2,0,0.5,0.5,false,false,850,250,850,250,0,0,0,true,true,true,-1.0
2,0,0.5,0.5,false,false,850,300,850,300,0,0,0,true,true,true,-1.0
2,0,0.5,0.5,false,false,300,250,847,297,547,47,3,true,true,true,-1.0
2,0,0.5,0.5,false,false,250,300,797,397,547,97,3,true,true,true,-1.0
2,0,0.5,0.5,false,false,300,250,799,299,499,49,1,true,true,true,-1.0
2,0,0.5,0.5,false,false,850,250,850,250,0,0,0,true,true,true,-1.0
2,1,0.5,0.5,true,false,200,850,197,847,-3,-3,3,false,false,false,859.333
2,1,0.5,0.5,true,false,350,200,347,197,-3,-3,3,true,true,true,-1.0
2,1,0.5,0.5,true,false,300,300,797,347,497,47,3,true,true,true,-1.0
2,1,0.5,0.5,true,false,200,300,348,798,148,498,2,true,true,true,-1.0
2,1,0.5,0.5,true,false,200,300,398,798,198,498,2,true,true,true,-1.0
2,1,0.5,0.5,true,false,350,300,350,300,0,0,0,true,true,true,-1.0
2,1,0.5,0.5,true,false,200,300,197,297,-3,-3,3,true,true,true,-1.0
2,1,0.5,0.5,true,false,300,300,250,250,-50,-50,50,false,false,false,-1.0
2,1,0.5,0.5,true,false,850,850,849,849,-1,-1,1,true,true,true,-1.0
2,1,0.5,0.5,true,false,250,200,349,249,99,49,1,true,true,true,-1.0
2,1,0.5,0.5,true,false,850,300,899,799,49,499,1,true,true,true,-1.0
2,1,0.5,0.5,true,false,250,850,249,849,-1,-1,1,true,true,true,-1.0
2,1,0.5,0.5,true,false,300,250,348,798,48,548,2,true,true,true,-1.0
2,1,0.5,0.5,true,false,250,200,799,249,549,49,1,true,true,true,-1.0
2,1,0.5,0.5,true,false,250,300,247,297,-3,-3,3,true,true,true,-1.0
2,1,0.5,0.5,true,false,250,300,796,346,546,46,4,true,true,true,-1.0
2,1,0.5,0.5,true,false,200,250,246,296,46,46,4,true,true,true,-1.0
2,1,0.5,0.5,true,false,300,200,297,197,-3,-3,3,true,true,true,-1.0
2,1,0.5,0.5,true,false,200,200,249,249,49,49,1,true,true,true,-1.0
2,1,0.5,0.5,true,false,300,200,300,200,0,0,0,true,true,true,-1.0
2,1,0.5,0.5,false,false,300,850,300,850,0,0,0,true,true,true,158.526
2,1,0.5,0.5,false,false,300,200,250,150,-50,-50,50,false,false,false,-1.0
2,1,0.5,0.5,false,false,200,900,150,850,-50,-50,50,false,false,false,-1.0
2,1,0.5,0.5,false,false,350,250,347,247,-3,-3,3,true,true,true,-1.0
2,1,0.5,0.5,false,false,250,200,299,249,49,49,1,true,true,true,-1.0
2,1,0.5,0.5,false,false,250,300,849,849,599,549,1,true,true,true,-1.0
2,1,0.5,0.5,false,false,200,300,249,799,49,499,1,true,true,true,-1.0
2,1,0.5,0.5,false,false,250,200,797,247,547,47,3,true,true,true,-1.0
2,1,0.5,0.5,false,false,300,300,250,250,-50,-50,50,false,false,false,-1.0
2,1,0.5,0.5,false,false,200,200,197,197,-3,-3,3,true,true,true,-1.0
2,1,0.5,0.5,false,false,900,300,899,299,-1,-1,1,true,true,true,-1.0
2,1,0.5,0.5,false,false,300,200,349,249,49,49,1,true,true,true,-1.0
2,1,0.5,0.5,false,false,200,300,280,780,80,480,20,true,true,true,-1.0
2,1,0.5,0.5,false,false,250,200,247,197,-3,-3,3,true,true,true,-1.0
2,1,0.5,0.5,false,false,300,200,300,200,0,0,0,true,true,true,-1.0
2,1,0.5,0.5,false,false,200,350,798,398,598,48,2,true,true,true,-1.0
2,1,0.5,0.5,false,false,850,300,847,297,-3,-3,3,true,true,true,-1.0
2,1,0.5,0.5,false,false,850,250,849,249,-1,-1,1,true,true,true,-1.0
2,1,0.5,0.5,false,false,250,250,250,250,0,0,0,true,true,true,-1.0
2,1,0.5,0.5,false,false,200,850,233,883,33,33,17,true,true,true,-1.0
2,2,0.5,0.5,true,true,200,300,799,899,599,599,1,true,true,true,564.493
2,2,0.5,0.5,true,true,300,850,298,848,-2,-2,2,true,true,true,-1.0
2,2,0.5,0.5,true,true,200,250,249,299,49,49,1,true,true,true,-1.0
2,2,0.5,0.5,true,true,200,200,298,348,98,148,2,true,true,true,-1.0
2,2,0.5,0.5,true,true,200,200,799,249,599,49,1,true,true,true,-1.0
2,2,0.5,0.5,true,true,250,300,249,299,-1,-1,1,true,true,true,-1.0
2,2,0.5,0.5,true,true,200,250,200,250,0,0,0,true,true,true,-1.0
2,2,0.5,0.5,true,true,200,200,199,199,-1,-1,1,true,true,true,-1.0
2,2,0.5,0.5,true,true,850,850,848,848,-2,-2,2,true,true,true,-1.0
2,2,0.5,0.5,true,true,850,250,850,250,0,0,0,true,true,true,-1.0
2,2,0.5,0.5,true,true,350,250,349,249,-1,-1,1,true,true,true,-1.0
2,2,0.5,0.5,true,true,250,300,248,298,-2,-2,2,true,true,true,-1.0
2,2,0.5,0.5,true,true,200,250,798,898,598,648,2,true,true,true,-1.0
2,2,0.5,0.5,true,true,300,250,799,349,499,99,1,true,true,true,-1.0
2,2,0.5,0.5,true,true,900,350,899,349,-1,-1,1,true,true,true,-1.0
2,2,0.5,0.5,true,true,250,250,248,248,-2,-2,2,true,true,true,-1.0
2,2,0.5,0.5,true,true,200,250,198,248,-2,-2,2,true,true,true,-1.0
2,2,0.5,0.5,true,true,200,300,150,250,-50,-50,50,false,false,false,-1.0
2,2,0.5,0.5,true,true,300,200,297,197,-3,-3,3,true,true,true,-1.0
2,2,0.5,0.5,true,true,850,250,898,798,48,548,2,true,true,true,-1.0
2,2,0.5,0.5,true,false,350,250,899,299,549,49,1,true,true,true,495.411
2,2,0.5,0.5,true,false,850,200,850,200,0,0,0,true,true,true,-1.0
2,2,0.5,0.5,true,false,250,250,335,285,85,35,15,true,true,true,-1.0
2,2,0.5,0.5,true,false,300,300,798,898,498,598,2,true,true,true,-1.0
2,2,0.5,0.5,true,false,200,850,199,849,-1,-1,1,true,true,true,-1.0
2,2,0.5,0.5,true,false,850,250,849,249,-1,-1,1,true,true,true,-1.0
2,2,0.5,0.5,true,false,300,250,898,298,598,48,2,true,true,true,-1.0
2,2,0.5,0.5,true,false,250,250,250,250,0,0,0,true,true,true,-1.0
2,2,0.5,0.5,true,false,850,350,845,345,-5,-5,5,true,true,true,-1.0
2,2,0.5,0.5,true,false,200,200,249,299,49,99,1,true,true,true,-1.0
2,2,0.5,0.5,true,false,300,300,798,898,498,598,2,true,true,true,-1.0
2,2,0.5,0.5,true,false,300,850,799,899,499,49,1,true,true,true,-1.0
2,2,0.5,0.5,true,false,200,200,199,199,-1,-1,1,true,true,true,-1.0
2,2,0.5,0.5,true,false,300,900,299,899,-1,-1,1,true,true,true,-1.0
2,2,0.5,0.5,true,false,350,350,350,350,0,0,0,true,true,true,-1.0
2,2,0.5,0.5,true,false,300,200,349,799,49,599,1,true,true,true,-1.0
2,2,0.5,0.5,true,false,900,250,900,250,0,0,0,true,true,true,-1.0
2,2,0.5,0.5,true,false,300,850,300,850,0,0,0,true,true,true,-1.0
2,2,0.5,0.5,true,false,850,200,850,200,0,0,0,true,true,true,-1.0
2,2,0.5,0.5,true,false,200,300,248,798,48,498,2,true,true,true,-1.0
2,2,0.5,0.5,false,true,200,900,199,899,-1,-1,1,true,true,true,163.682
2,2,0.5,0.5,false,true,250,850,248,848,-2,-2,2,true,true,true,-1.0
2,2,0.5,0.5,false,true,250,850,250,850,0,0,0,true,true,true,-1.0
2,2,0.5,0.5,false,true,250,300,348,798,98,498,2,true,true,true,-1.0
2,2,0.5,0.5,false,true,300,850,298,848,-2,-2,2,true,true,true,-1.0
2,2,0.5,0.5,false,true,300,350,298,348,-2,-2,2,true,true,true,-1.0
2,2,0.5,0.5,false,true,850,300,849,299,-1,-1,1,true,true,true,-1.0
2,2,0.5,0.5,false,true,300,300,299,299,-1,-1,1,true,true,true,-1.0
2,2,0.5,0.5,false,true,300,300,799,349,499,49,1,true,true,true,-1.0
2,2,0.5,0.5,false,true,300,850,299,849,-1,-1,1,true,true,true,-1.0
2,2,0.5,0.5,false,true,250,250,248,248,-2,-2,2,true,true,true,-1.0
2,2,0.5,0.5,false,true,300,250,299,249,-1,-1,1,true,true,true,-1.0
2,2,0.5,0.5,false,true,850,300,899,799,49,499,1,true,true,true,-1.0
2,2,0.5,0.5,false,true,850,200,850,200,0,0,0,true,true,true,-1.0
2,2,0.5,0.5,false,true,850,350,849,349,-1,-1,1,true,true,true,-1.0
2,2,0.5,0.5,false,true,250,250,248,248,-2,-2,2,true,true,true,-1.0
2,2,0.5,0.5,false,true,250,300,249,299,-1,-1,1,true,true,true,-1.0
2,2,0.5,0.5,false,true,250,850,249,849,-1,-1,1,true,true,true,-1.0
2,2,0.5,0.5,false,true,350,200,948,798,598,598,2,true,true,true,-1.0
2,2,0.5,0.5,false,true,200,300,949,799,749,499,1,true,true,true,-1.0
2,2,0.5,0.5,false,false,250,250,797,347,547,97,3,true,true,true,108.818
2,2,0.5,0.5,false,false,200,200,296,896,96,696,4,true,true,true,-1.0
2,2,0.5,0.5,false,false,300,850,798,898,498,48,2,true,true,true,-1.0
2,2,0.5,0.5,false,false,300,300,349,799,49,499,1,true,true,true,-1.0
2,2,0.5,0.5,false,false,200,250,798,898,598,648,2,true,true,true,-1.0
2,2,0.5,0.5,false,false,200,850,199,849,-1,-1,1,true,true,true,-1.0
2,2,0.5,0.5,false,false,300,300,298,298,-2,-2,2,true,true,true,-1.0
2,2,0.5,0.5,false,false,850,850,849,849,-1,-1,1,true,true,true,-1.0
2,2,0.5,0.5,false,false,850,200,850,200,0,0,0,true,true,true,-1.0
2,2,0.5,0.5,false,false,200,200,195,195,-5,-5,5,true,true,true,-1.0
2,2,0.5,0.5,false,false,300,250,798,348,498,98,2,true,true,true,-1.0
2,2,0.5,0.5,false,false,250,300,799,899,549,599,1,true,true,true,-1.0
2,2,0.5,0.5,false,false,850,300,898,798,48,498,2,true,true,true,-1.0
2,2,0.5,0.5,false,false,300,300,300,300,0,0,0,true,true,true,-1.0
2,2,0.5,0.5,false,false,850,200,897,247,47,47,3,true,true,true,-1.0
2,2,0.5,0.5,false,false,300,300,299,299,-1,-1,1,true,true,true,-1.0
2,2,0.5,0.5,false,false,300,300,798,348,498,48,2,true,true,true,-1.0
2,2,0.5,0.5,false,false,350,300,350,300,0,0,0,true,true,true,-1.0
2,2,0.5,0.5,false,false,850,850,848,848,-2,-2,2,true,true,true,-1.0
2,2,0.5,0.5,false,false,250,200,299,249,49,49,1,true,true,true,-1.0
0,0,0.5,0.5,false,false,250,300,246,296,-4,-4,4,true,true,true,0.22
0,0,0.5,0.5,false,false,200,250,298,798,98,548,2,true,true,true,-1.0
0,0,0.5,0.5,false,false,850,850,847,847,-3,-3,3,true,true,true,-1.0
0,0,0.5,0.5,false,false,200,300,248,798,48,498,2,true,true,true,-1.0
0,0,0.5,0.5,false,false,250,300,246,296,-4,-4,4,true,true,true,-1.0
0,0,0.5,0.5,false,false,350,300,346,296,-4,-4,4,true,true,true,-1.0
0,0,0.5,0.5,false,false,200,200,197,197,-3,-3,3,true,true,true,-1.0
0,0,0.5,0.5,false,false,900,300,896,296,-4,-4,4,true,true,true,-1.0
0,0,0.5,0.5,false,false,300,850,797,897,497,47,3,true,true,true,-1.0
0,0,0.5,0.5,false,false,350,300,348,298,-2,-2,2,true,true,true,-1.0
0,0,0.5,0.5,false,false,300,250,296,246,-4,-4,4,true,true,true,-1.0
0,0,0.5,0.5,false,false,200,200,248,248,48,48,2,true,true,true,-1.0
0,0,0.5,0.5,false,false,350,300,346,296,-4,-4,4,true,true,true,-1.0
0,0,0.5,0.5,false,false,300,300,797,347,497,47,3,true,false,true,-1.0
0,0,0.5,0.5,false,false,900,300,897,297,-3,-3,3,true,true,true,-1.0
0,0,0.5,0.5,false,false,300,350,296,346,-4,-4,4,true,true,true,-1.0
0,0,0.5,0.5,false,false,300,250,297,247,-3,-3,3,true,true,true,-1.0
0,0,0.5,0.5,false,false,350,300,348,298,-2,-2,2,true,true,true,-1.0
0,0,0.5,0.5,false,false,250,300,247,297,-3,-3,3,true,true,true,-1.0
0,0,0.5,0.5,false,false,300,350,296,346,-4,-4,4,true,true,true,-1.0
0,1,0.5,0.5,false,false,350,200,348,198,-2,-2,2,true,true,true,0.3
0,1,0.5,0.5,false,false,250,250,348,798,98,548,2,true,true,true,-1.0
0,1,0.5,0.5,false,false,250,850,298,898,48,48,2,true,true,true,-1.0
0,1,0.5,0.5,false,false,200,300,196,296,-4,-4,4,true,true,true,-1.0
0,1,0.5,0.5,false,false,300,850,296,846,-4,-4,4,true,true,true,-1.0
0,1,0.5,0.5,false,false,350,300,948,798,598,498,2,true,true,true,-1.0
0,1,0.5,0.5,false,false,350,850,348,848,-2,-2,2,true,true,true,-1.0
0,1,0.5,0.5,false,false,250,250,897,297,647,47,3,true,true,true,-1.0
0,1,0.5,0.5,false,false,300,200,348,248,48,48,2,true,true,true,-1.0
0,1,0.5,0.5,false,false,300,250,799,349,499,99,1,true,true,true,-1.0
0,1,0.5,0.5,false,false,250,200,348,798,98,598,2,true,true,true,-1.0
0,1,0.5,0.5,false,false,250,250,246,246,-4,-4,4,true,true,true,-1.0
0,1,0.5,0.5,false,false,250,300,298,798,48,498,2,true,true,true,-1.0
0,1,0.5,0.5,false,false,300,300,799,399,499,99,1,true,true,true,-1.0
0,1,0.5,0.5,false,false,850,250,848,248,-2,-2,2,false,false,false,-1.0
0,1,0.5,0.5,false,false,200,850,248,898,48,48,2,true,true,true,-1.0
0,1,0.5,0.5,false,false,350,250,948,798,598,548,2,true,true,true,-1.0
0,1,0.5,0.5,false,false,250,850,799,899,549,49,1,true,true,true,-1.0
0,1,0.5,0.5,false,false,300,350,296,346,-4,-4,4,true,true,true,-1.0
0,1,0.5,0.5,false,false,250,300,249,299,-1,-1,1,true,true,true,-1.0
0,2,0.5,0.5,false,true,850,350,849,349,-1,-1,1,true,true,true,308.007
0,2,0.5,0.5,false,true,900,350,898,348,-2,-2,2,true,true,true,-1.0
0,2,0.5,0.5,false,true,250,250,249,249,-1,-1,1,true,true,true,-1.0
0,2,0.5,0.5,false,true,850,250,849,249,-1,-1,1,true,true,true,-1.0
0,2,0.5,0.5,false,true,300,850,297,847,-3,-3,3,true,true,true,-1.0
0,2,0.5,0.5,false,true,250,250,348,798,98,548,2,true,true,true,-1.0
0,2,0.5,0.5,false,true,850,300,849,299,-1,-1,1,true,true,true,-1.0
0,2,0.5,0.5,false,true,850,250,848,248,-2,-2,2,true,true,true,-1.0
0,2,0.5,0.5,false,true,850,300,846,296,-4,-4,4,true,true,true,-1.0
0,2,0.5,0.5,false,true,350,850,347,847,-3,-3,3,true,true,true,-1.0
0,2,0.5,0.5,false,true,300,350,296,346,-4,-4,4,false,false,false,-1.0
0,2,0.5,0.5,false,true,200,250,196,246,-4,-4,4,true,true,true,-1.0
0,2,0.5,0.5,false,true,250,200,797,247,547,47,3,true,true,true,-1.0
0,2,0.5,0.5,false,true,200,250,799,299,599,49,1,true,true,true,-1.0
0,2,0.5,0.5,false,true,250,200,249,199,-1,-1,1,true,true,true,-1.0
0,2,0.5,0.5,false,true,300,200,298,198,-2,-2,2,true,true,true,-1.0
0,2,0.5,0.5,false,true,250,250,246,246,-4,-4,4,true,true,true,-1.0
0,2,0.5,0.5,false,true,300,250,799,299,499,49,1,true,true,true,-1.0
0,2,0.5,0.5,false,true,350,850,349,849,-1,-1,1,true,true,true,-1.0
0,2,0.5,0.5,false,true,250,250,247,247,-3,-3,3,true,true,true,-1.0
0,2,0.5,0.5,false,false,300,350,297,347,-3,-3,3,true,true,true,77.047
0,2,0.5,0.5,false,false,850,300,846,296,-4,-4,4,true,true,true,-1.0
0,2,0.5,0.5,false,false,200,350,297,397,97,47,3,true,true,true,-1.0
0,2,0.5,0.5,false,false,300,350,299,349,-1,-1,1,true,true,true,-1.0
0,2,0.5,0.5,false,false,250,850,246,846,-4,-4,4,true,true,true,-1.0
0,2,0.5,0.5,false,false,200,250,298,798,98,548,2,true,true,true,-1.0
0,2,0.5,0.5,false,false,250,200,246,196,-4,-4,4,true,true,true,-1.0
0,2,0.5,0.5,false,false,250,300,246,296,-4,-4,4,true,true,true,-1.0
0,2,0.5,0.5,false,false,200,850,799,899,599,49,1,true,true,true,-1.0
0,2,0.5,0.5,false,false,300,300,348,798,48,498,2,true,true,true,-1.0
0,2,0.5,0.5,false,false,250,850,249,849,-1,-1,1,true,true,true,-1.0
0,2,0.5,0.5,false,false,250,250,246,246,-4,-4,4,true,true,true,-1.0
0,2,0.5,0.5,false,false,250,300,298,848,48,548,2,true,true,true,-1.0
0,2,0.5,0.5,false,false,200,900,196,896,-4,-4,4,true,true,true,-1.0
0,2,0.5,0.5,false,false,300,200,299,199,-1,-1,1,true,true,true,-1.0
0,2,0.5,0.5,false,false,300,300,799,899,499,599,1,true,true,true,-1.0
0,2,0.5,0.5,false,false,300,300,296,296,-4,-4,4,true,true,true,-1.0
0,2,0.5,0.5,false,false,300,350,299,349,-1,-1,1,true,true,true,-1.0
0,2,0.5,0.5,false,false,300,850,299,849,-1,-1,1,true,true,true,-1.0
0,2,0.5,0.5,false,false,200,250,196,246,-4,-4,4,true,true,true,-1.0
1,0,0.5,0.5,false,false,250,250,250,250,0,0,0,false,false,false,0.374
1,0,0.5,0.5,false,false,850,200,847,197,-3,-3,3,true,true,true,-1.0
1,0,0.5,0.5,false,false,350,850,350,850,0,0,0,true,true,true,-1.0
1,0,0.5,0.5,false,false,300,300,300,300,0,0,0,true,true,true,-1.0
1,0,0.5,0.5,false,false,250,300,799,349,549,49,1,true,true,true,-1.0
1,0,0.5,0.5,false,false,200,250,248,798,48,548,2,true,true,true,-1.0
1,0,0.5,0.5,false,false,350,250,345,245,-5,-5,5,true,true,true,-1.0
1,0,0.5,0.5,false,false,300,850,297,847,-3,-3,3,true,true,true,-1.0
1,0,0.5,0.5,false,false,300,250,297,247,-3,-3,3,true,true,true,-1.0
1,0,0.5,0.5,false,false,850,350,845,345,-5,-5,5,true,true,true,-1.0
1,0,0.5,0.5,false,false,300,350,295,345,-5,-5,5,true,true,true,-1.0
1,0,0.5,0.5,false,false,200,200,200,200,0,0,0,true,true,true,-1.0
1,0,0.5,0.5,false,false,300,300,300,300,0,0,0,true,true,true,-1.0
1,0,0.5,0.5,false,false,300,300,797,347,497,47,3,true,true,true,-1.0
1,0,0.5,0.5,false,false,300,850,297,847,-3,-3,3,true,true,true,-1.0
1,0,0.5,0.5,false,false,250,300,296,796,46,496,4,true,true,true,-1.0
1,0,0.5,0.5,false,false,850,300,848,298,-2,-2,2,true,true,true,-1.0
1,0,0.5,0.5,false,false,200,200,200,200,0,0,0,true,true,true,-1.0
1,0,0.5,0.5,false,false,350,300,347,297,-3,-3,3,true,true,true,-1.0
1,0,0.5,0.5,false,false,300,350,295,345,-5,-5,5,true,true,true,-1.0
1,1,0.5,0.5,false,false,300,300,348,798,48,498,2,true,true,true,1.3
1,1,0.5,0.5,false,false,300,300,250,250,-50,-50,50,false,false,false,-1.0
1,1,0.5,0.5,false,false,250,250,200,200,-50,-50,50,true,true,true,-1.0
1,1,0.5,0.5,false,false,850,250,850,250,0,0,0,true,true,true,-1.0
1,1,0.5,0.5,false,false,850,200,898,298,48,98,2,true,true,true,-1.0
1,1,0.5,0.5,false,false,200,250,298,798,98,548,2,true,true,true,-1.0
1,1,0.5,0.5,false,false,850,250,850,250,0,0,0,true,true,true,-1.0
1,1,0.5,0.5,false,false,200,250,249,299,49,49,1,true,false,true,-1.0
1,1,0.5,0.5,false,false,850,850,800,800,-50,-50,50,true,true,true,-1.0
1,1,0.5,0.5,false,false,300,300,300,300,0,0,0,true,true,true,-1.0
1,1,0.5,0.5,false,false,300,250,297,247,-3,-3,3,true,true,true,-1.0
1,1,0.5,0.5,false,false,850,250,800,200,-50,-50,50,true,true,true,-1.0
1,1,0.5,0.5,false,false,300,250,799,899,499,649,1,true,true,true,-1.0
1,1,0.5,0.5,false,false,350,850,347,847,-3,-3,3,true,true,true,-1.0
1,1,0.5,0.5,false,false,300,200,799,299,499,99,1,true,true,true,-1.0
1,1,0.5,0.5,false,false,250,300,799,349,549,49,1,true,true,true,-1.0
1,1,0.5,0.5,false,false,850,200,850,200,0,0,0,true,true,true,-1.0
1,1,0.5,0.5,false,false,200,300,898,798,698,498,2,true,true,true,-1.0
1,1,0.5,0.5,false,false,250,350,799,949,549,599,1,true,true,true,-1.0
1,1,0.5,0.5,false,false,300,850,250,800,-50,-50,50,true,true,true,-1.0
1,2,0.5,0.5,false,true,300,300,300,300,0,0,0,true,true,true,523.76
1,2,0.5,0.5,false,true,350,250,338,238,-12,-12,12,true,true,true,-1.0
1,2,0.5,0.5,false,true,300,250,797,397,497,147,3,true,true,true,-1.0
1,2,0.5,0.5,false,true,300,250,349,799,49,549,1,true,true,true,-1.0
1,2,0.5,0.5,false,true,200,250,198,248,-2,-2,2,true,true,true,-1.0
1,2,0.5,0.5,false,true,250,350,250,350,0,0,0,true,true,true,-1.0
1,2,0.5,0.5,false,true,250,250,248,248,-2,-2,2,true,true,true,-1.0
1,2,0.5,0.5,false,true,850,350,850,350,0,0,0,true,true,true,-1.0
1,2,0.5,0.5,false,true,200,200,198,198,-2,-2,2,true,true,true,-1.0
1,2,0.5,0.5,false,true,250,300,785,385,535,85,15,true,true,true,-1.0
1,2,0.5,0.5,false,true,300,200,280,180,-20,-20,20,true,true,true,-1.0
1,2,0.5,0.5,false,true,300,200,298,198,-2,-2,2,false,false,false,-1.0
1,2,0.5,0.5,false,true,900,300,900,300,0,0,0,true,true,true,-1.0
1,2,0.5,0.5,false,true,200,850,200,850,0,0,0,true,true,true,-1.0
1,2,0.5,0.5,false,true,850,250,850,250,0,0,0,true,true,true,-1.0
1,2,0.5,0.5,false,true,300,250,298,248,-2,-2,2,true,true,true,-1.0
1,2,0.5,0.5,false,true,200,350,198,348,-2,-2,2,true,true,true,-1.0
1,2,0.5,0.5,false,true,200,200,196,196,-4,-4,4,true,true,true,-1.0
1,2,0.5,0.5,false,true,200,350,198,348,-2,-2,2,true,true,true,-1.0
1,2,0.5,0.5,false,true,300,200,298,198,-2,-2,2,true,true,true,-1.0
1,2,0.5,0.5,false,false,250,850,248,848,-2,-2,2,true,true,true,109.762
1,2,0.5,0.5,false,false,250,300,797,897,547,597,3,true,true,true,-1.0
1,2,0.5,0.5,false,false,250,850,799,899,549,49,1,true,true,true,-1.0
1,2,0.5,0.5,false,false,350,250,890,340,540,90,10,true,true,true,-1.0
1,2,0.5,0.5,false,false,200,300,199,299,-1,-1,1,true,true,true,-1.0
1,2,0.5,0.5,false,false,300,350,848,898,548,548,2,true,true,true,-1.0
1,2,0.5,0.5,false,false,300,300,799,899,499,599,1,true,true,true,-1.0
1,2,0.5,0.5,false,false,250,200,799,899,549,699,1,true,true,true,-1.0
1,2,0.5,0.5,false,false,250,300,349,799,99,499,1,true,true,true,-1.0
1,2,0.5,0.5,false,false,200,300,199,299,-1,-1,1,true,true,true,-1.0
1,2,0.5,0.5,false,false,250,200,775,225,525,25,25,true,true,true,-1.0
1,2,0.5,0.5,false,false,200,350,249,899,49,549,1,true,true,true,-1.0
1,2,0.5,0.5,false,false,850,300,844,294,-6,-6,6,true,true,true,-1.0
1,2,0.5,0.5,false,false,300,300,300,300,0,0,0,true,true,true,-1.0
1,2,0.5,0.5,false,false,250,850,248,848,-2,-2,2,true,true,true,-1.0
1,2,0.5,0.5,false,false,350,250,348,248,-2,-2,2,true,true,true,-1.0
1,2,0.5,0.5,false,false,250,200,250,200,0,0,0,true,true,true,-1.0
1,2,0.5,0.5,false,false,200,350,200,350,0,0,0,true,true,true,-1.0
1,2,0.5,0.5,false,false,300,250,398,798,98,548,2,true,true,true,-1.0
1,2,0.5,0.5,false,false,300,250,799,899,499,649,1,true,true,true,-1.0
2,0,0.5,0.5,true,false,200,300,797,897,597,597,3,true,true,true,585.136
2,0,0.5,0.5,true,false,200,850,197,847,-3,-3,3,true,true,true,-1.0
2,0,0.5,0.5,true,false,350,250,347,247,-3,-3,3,true,true,true,-1.0
2,0,0.5,0.5,true,false,200,300,197,297,-3,-3,3,true,true,true,-1.0
2,0,0.5,0.5,true,false,850,200,845,195,-5,-5,5,true,true,true,-1.0
2,0,0.5,0.5,true,false,250,200,797,297,547,97,3,true,true,true,-1.0
2,0,0.5,0.5,true,false,350,200,345,195,-5,-5,5,true,true,true,-1.0
2,0,0.5,0.5,true,false,350,250,350,250,0,0,0,true,true,true,-1.0
2,0,0.5,0.5,true,false,300,250,300,250,0,0,0,true,true,true,-1.0
2,0,0.5,0.5,true,false,200,850,197,847,-3,-3,3,false,false,false,-1.0
2,0,0.5,0.5,true,false,200,250,349,799,149,549,1,true,true,true,-1.0
2,0,0.5,0.5,true,false,250,200,250,200,0,0,0,true,true,true,-1.0
2,0,0.5,0.5,true,false,200,300,197,297,-3,-3,3,true,true,true,-1.0
2,0,0.5,0.5,true,false,200,850,197,847,-3,-3,3,true,true,true,-1.0
2,0,0.5,0.5,true,false,300,850,797,897,497,47,3,true,true,true,-1.0
2,0,0.5,0.5,true,false,250,250,797,347,547,97,3,true,true,true,-1.0
2,0,0.5,0.5,true,false,350,250,350,250,0,0,0,true,true,true,-1.0
2,0,0.5,0.5,true,false,250,300,898,798,648,498,2,true,true,true,-1.0
2,0,0.5,0.5,true,false,300,300,295,295,-5,-5,5,true,true,true,-1.0
2,0,0.5,0.5,true,false,850,200,899,799,49,599,1,true,true,true,-1.0
2,0,0.5,0.5,false,false,300,300,849,849,549,549,1,true,true,true,99.829
2,0,0.5,0.5,false,false,200,850,197,847,-3,-3,3,false,false,false,-1.0
2,0,0.5,0.5,false,false,250,300,247,297,-3,-3,3,true,true,true,-1.0
2,0,0.5,0.5,false,false,300,300,295,295,-5,-5,5,true,true,true,-1.0
2,0,0.5,0.5,false,false,350,850,347,847,-3,-3,3,true,true,true,-1.0
2,0,0.5,0.5,false,false,200,350,197,347,-3,-3,3,true,true,true,-1.0
2,0,0.5,0.5,false,false,850,200,899,299,49,99,1,true,true,true,-1.0
2,0,0.5,0.5,false,false,250,250,847,297,597,47,3,true,true,true,-1.0
2,0,0.5,0.5,false,false,250,300,299,799,49,499,1,true,true,true,-1.0
2,0,0.5,0.5,false,false,250,250,245,245,-5,-5,5,true,true,true,-1.0
2,0,0.5,0.5,false,false,850,250,897,797,47,547,3,true,true,true,-1.0
2,0,0.5,0.5,false,false,200,250,797,297,597,47,3,true,true,true,-1.0
2,0,0.5,0.5,false,false,850,300,848,298,-2,-2,2,true,true,true,-1.0
2,0,0.5,0.5,false,false,200,300,248,798,48,498,2,true,true,true,-1.0
2,0,0.5,0.5,false,false,250,300,299,799,49,499,1,true,true,true,-1.0
2,0,0.5,0.5,false,false,200,200,195,195,-5,-5,5,true,true,true,-1.0
2,0,0.5,0.5,false,false,200,850,197,847,-3,-3,3,true,true,true,-1.0
2,0,0.5,0.5,false,false,300,200,349,799,49,599,1,true,true,true,-1.0
2,0,0.5,0.5,false,false,850,850,847,847,-3,-3,3,true,true,true,-1.0
2,0,0.5,0.5,false,false,850,300,850,300,0,0,0,true,true,true,-1.0
2,1,0.5,0.5,true,false,250,250,250,250,0,0,0,true,true,true,876.249
2,1,0.5,0.5,true,false,250,250,200,200,-50,-50,50,false,false,false,-1.0
2,1,0.5,0.5,true,false,850,200,899,799,49,599,1,true,true,true,-1.0
2,1,0.5,0.5,true,false,850,200,847,197,-3,-3,3,true,true,true,-1.0
2,1,0.5,0.5,true,false,250,200,847,847,597,647,3,true,true,true,-1.0
2,1,0.5,0.5,true,false,200,300,197,297,-3,-3,3,true,true,true,-1.0
2,1,0.5,0.5,true,false,300,300,300,300,0,0,0,true,true,true,-1.0
2,1,0.5,0.5,true,false,350,250,399,799,49,549,1,true,true,true,-1.0
2,1,0.5,0.5,true,false,300,350,297,347,-3,-3,3,true,true,true,-1.0
2,1,0.5,0.5,true,false,300,350,297,347,-3,-3,3,true,true,true,-1.0
2,1,0.5,0.5,true,false,250,900,245,895,-5,-5,5,true,true,true,-1.0
2,1,0.5,0.5,true,false,850,300,847,297,-3,-3,3,true,true,true,-1.0
2,1,0.5,0.5,true,false,300,350,297,347,-3,-3,3,false,false,false,-1.0
2,1,0.5,0.5,true,false,300,250,898,798,598,548,2,true,true,true,-1.0
2,1,0.5,0.5,true,false,200,250,200,250,0,0,0,true,true,true,-1.0
2,1,0.5,0.5,true,false,350,250,350,250,0,0,0,true,true,true,-1.0
2,1,0.5,0.5,true,false,350,850,347,847,-3,-3,3,true,true,true,-1.0
2,1,0.5,0.5,true,false,850,850,850,850,0,0,0,true,true,true,-1.0
2,1,0.5,0.5,true,false,350,250,350,250,0,0,0,true,true,true,-1.0
2,1,0.5,0.5,true,false,350,300,350,300,0,0,0,true,true,true,-1.0
2,1,0.5,0.5,false,false,850,300,898,798,48,498,2,true,true,true,126.666
2,1,0.5,0.5,false,false,300,350,297,347,-3,-3,3,true,true,true,-1.0
2,1,0.5,0.5,false,false,200,850,226,876,26,26,24,true,true,true,-1.0
2,1,0.5,0.5,false,false,200,850,296,896,96,46,4,true,true,true,-1.0
2,1,0.5,0.5,false,false,300,250,799,349,499,99,1,true,true,true,-1.0
2,1,0.5,0.5,false,false,200,250,197,247,-3,-3,3,true,true,true,-1.0
2,1,0.5,0.5,false,false,250,250,233,233,-17,-17,17,true,true,true,-1.0
2,1,0.5,0.5,false,false,850,200,899,249,49,49,1,true,true,true,-1.0
2,1,0.5,0.5,false,false,350,300,899,849,549,549,1,true,true,true,-1.0
2,1,0.5,0.5,false,false,850,250,847,247,-3,-3,3,true,true,true,-1.0
2,1,0.5,0.5,false,false,250,900,247,897,-3,-3,3,true,true,true,-1.0
2,1,0.5,0.5,false,false,300,850,300,850,0,0,0,true,true,true,-1.0
2,1,0.5,0.5,false,false,900,850,900,850,0,0,0,true,true,true,-1.0
2,1,0.5,0.5,false,false,900,250,897,247,-3,-3,3,true,true,true,-1.0
2,1,0.5,0.5,false,false,200,300,197,297,-3,-3,3,true,true,true,-1.0
2,1,0.5,0.5,false,false,300,850,300,850,0,0,0,true,true,true,-1.0
2,1,0.5,0.5,false,false,850,200,850,200,0,0,0,true,true,true,-1.0
2,1,0.5,0.5,false,false,250,300,247,297,-3,-3,3,true,true,true,-1.0
2,1,0.5,0.5,false,false,200,850,175,825,-25,-25,25,true,true,true,-1.0
2,1,0.5,0.5,false,false,850,200,850,200,0,0,0,true,true,true,-1.0
2,2,0.5,0.5,true,true,300,350,848,898,548,548,2,true,true,true,528.618
2,2,0.5,0.5,true,true,250,250,296,296,46,46,4,true,true,true,-1.0
2,2,0.5,0.5,true,true,300,850,299,849,-1,-1,1,true,true,true,-1.0
2,2,0.5,0.5,true,true,850,300,849,299,-1,-1,1,true,true,true,-1.0
2,2,0.5,0.5,true,true,850,300,899,799,49,499,1,true,true,true,-1.0
2,2,0.5,0.5,true,true,200,300,199,299,-1,-1,1,true,true,true,-1.0
2,2,0.5,0.5,true,true,300,300,299,299,-1,-1,1,true,true,true,-1.0
2,2,0.5,0.5,true,true,250,200,299,249,49,49,1,true,true,true,-1.0
2,2,0.5,0.5,true,true,200,350,197,347,-3,-3,3,true,true,true,-1.0
2,2,0.5,0.5,true,true,250,350,249,349,-1,-1,1,true,true,true,-1.0
2,2,0.5,0.5,true,true,350,200,350,200,0,0,0,true,true,true,-1.0
2,2,0.5,0.5,true,true,200,350,798,398,598,48,2,true,true,true,-1.0
2,2,0.5,0.5,true,true,250,300,298,848,48,548,2,true,true,true,-1.0
2,2,0.5,0.5,true,true,300,300,799,349,499,49,1,true,true,true,-1.0
2,2,0.5,0.5,true,true,250,300,250,300,0,0,0,true,true,true,-1.0
2,2,0.5,0.5,true,true,250,200,250,200,0,0,0,true,true,true,-1.0
2,2,0.5,0.5,true,true,250,850,249,849,-1,-1,1,true,true,true,-1.0
2,2,0.5,0.5,true,true,250,900,249,899,-1,-1,1,true,true,true,-1.0
2,2,0.5,0.5,true,true,300,850,299,849,-1,-1,1,true,true,true,-1.0
2,2,0.5,0.5,true,true,200,300,200,300,0,0,0,true,true,true,-1.0
2,2,0.5,0.5,true,false,250,200,797,247,547,47,3,true,true,true,492.7
2,2,0.5,0.5,true,false,350,300,349,299,-1,-1,1,true,true,true,-1.0
2,2,0.5,0.5,true,false,300,300,798,898,498,598,2,true,true,true,-1.0
2,2,0.5,0.5,true,false,250,300,248,298,-2,-2,2,true,true,true,-1.0
2,2,0.5,0.5,true,false,200,300,199,299,-1,-1,1,true,true,true,-1.0
2,2,0.5,0.5,true,false,200,850,200,850,0,0,0,false,false,false,-1.0
2,2,0.5,0.5,true,false,850,300,850,300,0,0,0,true,true,true,-1.0
2,2,0.5,0.5,true,false,850,300,898,798,48,498,2,true,true,true,-1.0
2,2,0.5,0.5,true,false,850,300,898,798,48,498,2,true,true,true,-1.0
2,2,0.5,0.5,true,false,850,200,850,200,0,0,0,true,true,true,-1.0
2,2,0.5,0.5,true,false,850,300,849,299,-1,-1,1,true,true,true,-1.0
2,2,0.5,0.5,true,false,250,250,349,799,99,549,1,true,true,true,-1.0
2,2,0.5,0.5,true,false,300,300,299,299,-1,-1,1,true,true,true,-1.0
2,2,0.5,0.5,true,false,250,350,798,948,548,598,2,true,true,true,-1.0
2,2,0.5,0.5,true,false,300,250,847,297,547,47,3,true,true,true,-1.0
2,2,0.5,0.5,true,false,250,200,250,200,0,0,0,true,true,true,-1.0
2,2,0.5,0.5,true,false,200,200,198,198,-2,-2,2,true,true,true,-1.0
2,2,0.5,0.5,true,false,200,850,249,899,49,49,1,true,true,true,-1.0
2,2,0.5,0.5,true,false,250,850,248,848,-2,-2,2,true,true,true,-1.0
2,2,0.5,0.5,true,false,250,850,249,849,-1,-1,1,true,true,true,-1.0
2,2,0.5,0.5,false,true,250,300,298,348,48,48,2,true,true,true,211.087
2,2,0.5,0.5,false,true,250,850,248,848,-2,-2,2,true,true,true,-1.0
2,2,0.5,0.5,false,true,200,200,249,799,49,599,1,true,true,true,-1.0
2,2,0.5,0.5,false,true,300,300,298,298,-2,-2,2,true,true,true,-1.0
2,2,0.5,0.5,false,true,250,250,399,799,149,549,1,true,true,true,-1.0
2,2,0.5,0.5,false,true,850,250,850,250,0,0,0,true,true,true,-1.0
2,2,0.5,0.5,false,true,250,200,248,198,-2,-2,2,true,true,true,-1.0
2,2,0.5,0.5,false,true,250,850,249,849,-1,-1,1,true,true,true,-1.0
2,2,0.5,0.5,false,true,300,300,299,299,-1,-1,1,true,true,true,-1.0
2,2,0.5,0.5,false,true,300,300,799,349,499,49,1,true,true,true,-1.0
2,2,0.5,0.5,false,true,250,250,298,798,48,548,2,true,true,true,-1.0
2,2,0.5,0.5,false,true,200,200,199,199,-1,-1,1,true,true,true,-1.0
2,2,0.5,0.5,false,true,300,300,299,299,-1,-1,1,true,true,true,-1.0
2,2,0.5,0.5,false,true,300,300,299,299,-1,-1,1,true,true,true,-1.0
2,2,0.5,0.5,false,true,850,250,850,250,0,0,0,true,true,true,-1.0
2,2,0.5,0.5,false,true,250,300,248,298,-2,-2,2,true,true,true,-1.0
2,2,0.5,0.5,false,true,250,200,246,196,-4,-4,4,true,true,true,-1.0
2,2,0.5,0.5,false,true,900,850,900,850,0,0,0,true,true,true,-1.0
2,2,0.5,0.5,false,true,300,200,299,199,-1,-1,1,true,true,true,-1.0
2,2,0.5,0.5,false,true,300,200,798,898,498,698,2,true,true,true,-1.0
2,2,0.5,0.5,false,false,250,300,249,299,-1,-1,1,true,true,true,100.273
2,2,0.5,0.5,false,false,300,350,799,949,499,599,1,true,true,true,-1.0
2,2,0.5,0.5,false,false,300,250,297,247,-3,-3,3,true,true,true,-1.0
2,2,0.5,0.5,false,false,250,300,299,799,49,499,1,true,true,true,-1.0
2,2,0.5,0.5,false,false,250,300,797,347,547,47,3,true,true,true,-1.0
2,2,0.5,0.5,false,false,250,200,249,199,-1,-1,1,true,true,true,-1.0
2,2,0.5,0.5,false,false,200,200,199,199,-1,-1,1,true,true,true,-1.0
2,2,0.5,0.5,false,false,300,850,798,898,498,48,2,true,true,true,-1.0
2,2,0.5,0.5,false,false,200,250,248,298,48,48,2,true,true,true,-1.0
2,2,0.5,0.5,false,false,200,250,199,249,-1,-1,1,true,true,true,-1.0
2,2,0.5,0.5,false,false,250,850,798,898,548,48,2,true,true,true,-1.0
2,2,0.5,0.5,false,false,250,250,298,798,48,548,2,true,true,true,-1.0
2,2,0.5,0.5,false,false,300,850,298,848,-2,-2,2,true,true,true,-1.0
2,2,0.5,0.5,false,false,250,200,851,201,601,1,49,true,true,true,-1.0
2,2,0.5,0.5,false,false,250,350,249,349,-1,-1,1,true,true,true,-1.0
2,2,0.5,0.5,false,false,350,850,349,849,-1,-1,1,true,true,true,-1.0
2,2,0.5,0.5,false,false,850,300,850,300,0,0,0,true,true,true,-1.0
2,2,0.5,0.5,false,false,350,350,349,349,-1,-1,1,true,true,true,-1.0
2,2,0.5,0.5,false,false,300,850,798,898,498,48,2,true,true,true,-1.0
2,2,0.5,0.5,false,false,300,250,299,249,-1,-1,1,true,true,true,-1.0
0,0,0.5,0.5,false,false,300,250,799,899,499,649,1,true,true,true,0.217
0,0,0.5,0.5,false,false,850,200,846,196,-4,-4,4,true,true,true,-1.0
0,0,0.5,0.5,false,false,200,200,247,247,47,47,3,true,true,true,-1.0
0,0,0.5,0.5,false,false,300,850,797,897,497,47,3,true,true,true,-1.0
0,0,0.5,0.5,false,false,300,250,297,247,-3,-3,3,false,false,false,-1.0
0,0,0.5,0.5,false,false,300,250,348,798,48,548,2,true,true,true,-1.0
0,0,0.5,0.5,false,false,850,200,847,197,-3,-3,3,true,true,true,-1.0
0,0,0.5,0.5,false,false,850,200,847,197,-3,-3,3,false,false,false,-1.0
0,0,0.5,0.5,false,false,850,200,898,798,48,598,2,true,true,true,-1.0
0,0,0.5,0.5,false,false,900,300,896,296,-4,-4,4,true,true,true,-1.0
0,0,0.5,0.5,false,false,350,350,897,897,547,547,3,true,true,true,-1.0
0,0,0.5,0.5,false,false,300,850,297,847,-3,-3,3,true,true,true,-1.0
0,0,0.5,0.5,false,false,900,250,948,798,48,548,2,true,true,true,-1.0
0,0,0.5,0.5,false,false,200,850,197,847,-3,-3,3,false,false,false,-1.0
0,0,0.5,0.5,false,false,250,250,298,798,48,548,2,true,true,true,-1.0
0,0,0.5,0.5,false,false,200,850,197,847,-3,-3,3,false,false,false,-1.0
0,0,0.5,0.5,false,false,200,850,197,847,-3,-3,3,true,true,true,-1.0
0,0,0.5,0.5,false,false,300,200,348,798,48,598,2,false,false,true,-1.0
0,0,0.5,0.5,false,false,850,300,846,296,-4,-4,4,true,true,true,-1.0
0,0,0.5,0.5,false,false,250,300,247,297,-3,-3,3,true,true,true,-1.0
0,1,0.5,0.5,false,false,900,250,896,246,-4,-4,4,true,true,true,0.366
0,1,0.5,0.5,false,false,200,250,248,798,48,548,2,true,true,true,-1.0
0,1,0.5,0.5,false,false,200,300,199,299,-1,-1,1,true,true,true,-1.0
0,1,0.5,0.5,false,false,300,300,797,347,497,47,3,true,true,true,-1.0
0,1,0.5,0.5,false,false,200,300,248,798,48,498,2,true,true,true,-1.0
0,1,0.5,0.5,false,false,250,850,799,899,549,49,1,true,true,true,-1.0
0,1,0.5,0.5,false,false,200,300,849,899,649,599,1,true,true,true,-1.0
0,1,0.5,0.5,false,false,850,350,846,346,-4,-4,4,true,true,true,-1.0
0,1,0.5,0.5,false,false,850,250,898,798,48,548,2,true,true,true,-1.0
0,1,0.5,0.5,false,false,200,250,348,798,148,548,2,true,false,true,-1.0
0,1,0.5,0.5,false,false,300,850,299,849,-1,-1,1,true,true,true,-1.0
0,1,0.5,0.5,false,false,250,300,296,346,46,46,4,true,true,true,-1.0
0,1,0.5,0.5,false,false,200,250,248,798,48,548,2,true,true,true,-1.0
0,1,0.5,0.5,false,false,350,250,349,249,-1,-1,1,true,true,true,-1.0
0,1,0.5,0.5,false,false,200,900,248,948,48,48,2,true,true,true,-1.0
0,1,0.5,0.5,false,false,350,300,398,798,48,498,2,true,true,true,-1.0
0,1,0.5,0.5,false,false,300,300,348,798,48,498,2,true,true,true,-1.0
0,1,0.5,0.5,false,false,200,300,799,949,599,649,1,true,true,true,-1.0
0,1,0.5,0.5,false,false,850,850,849,849,-1,-1,1,true,true,true,-1.0
0,1,0.5,0.5,false,false,850,250,846,246,-4,-4,4,true,true,true,-1.0
0,2,0.5,0.5,false,true,200,850,199,849,-1,-1,1,true,true,true,494.864
0,2,0.5,0.5,false,true,300,300,296,296,-4,-4,4,true,true,true,-1.0
0,2,0.5,0.5,false,true,900,200,948,798,48,598,2,true,true,true,-1.0
0,2,0.5,0.5,false,true,250,850,798,898,548,48,2,true,true,true,-1.0
0,2,0.5,0.5,false,true,200,300,197,297,-3,-3,3,true,true,true,-1.0
0,2,0.5,0.5,false,true,250,850,298,898,48,48,2,true,true,true,-1.0
0,2,0.5,0.5,false,true,350,300,348,298,-2,-2,2,true,true,true,-1.0
0,2,0.5,0.5,false,true,900,250,898,248,-2,-2,2,true,true,true,-1.0
0,2,0.5,0.5,false,true,300,200,799,249,499,49,1,true,true,true,-1.0
0,2,0.5,0.5,false,true,300,300,897,847,597,547,3,true,true,true,-1.0
0,2,0.5,0.5,false,true,300,900,297,897,-3,-3,3,true,true,true,-1.0
0,2,0.5,0.5,false,true,350,850,346,846,-4,-4,4,true,true,true,-1.0
0,2,0.5,0.5,false,true,200,300,248,798,48,498,2,true,true,true,-1.0
0,2,0.5,0.5,false,true,250,250,249,249,-1,-1,1,true,true,true,-1.0
0,2,0.5,0.5,false,true,900,350,899,349,-1,-1,1,true,true,true,-1.0
0,2,0.5,0.5,false,true,250,200,799,349,549,149,1,true,true,true,-1.0
0,2,0.5,0.5,false,true,300,250,797,297,497,47,3,true,true,true,-1.0
0,2,0.5,0.5,false,true,850,250,846,246,-4,-4,4,true,true,true,-1.0
0,2,0.5,0.5,false,true,300,300,797,347,497,47,3,true,true,true,-1.0
0,2,0.5,0.5,false,true,250,850,799,899,549,49,1,true,true,true,-1.0
0,2,0.5,0.5,false,false,350,300,346,296,-4,-4,4,true,true,true,71.006
0,2,0.5,0.5,false,false,200,300,248,398,48,98,2,true,true,true,-1.0
0,2,0.5,0.5,false,false,300,300,296,296,-4,-4,4,true,true,true,-1.0
0,2,0.5,0.5,false,false,350,350,349,349,-1,-1,1,true,true,true,-1.0
0,2,0.5,0.5,false,false,300,250,348,798,48,548,2,true,true,true,-1.0
0,2,0.5,0.5,false,false,300,850,299,849,-1,-1,1,true,true,true,-1.0
0,2,0.5,0.5,false,false,200,200,248,798,48,598,2,true,true,true,-1.0
0,2,0.5,0.5,false,false,250,300,249,299,-1,-1,1,true,true,true,-1.0
0,2,0.5,0.5,false,false,200,850,248,898,48,48,2,true,true,true,-1.0
0,2,0.5,0.5,false,false,300,200,296,196,-4,-4,4,true,true,true,-1.0
0,2,0.5,0.5,false,false,900,250,896,246,-4,-4,4,true,true,true,-1.0
0,2,0.5,0.5,false,false,250,900,247,897,-3,-3,3,true,true,true,-1.0
0,2,0.5,0.5,false,false,250,850,246,846,-4,-4,4,true,true,true,-1.0
0,2,0.5,0.5,false,false,300,350,299,349,-1,-1,1,true,true,true,-1.0
0,2,0.5,0.5,false,false,300,900,299,899,-1,-1,1,true,true,true,-1.0
0,2,0.5,0.5,false,false,300,350,296,346,-4,-4,4,true,true,true,-1.0
0,2,0.5,0.5,false,false,200,200,248,298,48,98,2,true,false,true,-1.0
0,2,0.5,0.5,false,false,250,300,797,347,547,47,3,true,true,true,-1.0
0,2,0.5,0.5,false,false,350,850,346,846,-4,-4,4,true,true,true,-1.0
0,2,0.5,0.5,false,false,300,300,797,347,497,47,3,true,true,true,-1.0
1,0,0.5,0.5,false,false,250,250,797,297,547,47,3,true,true,true,0.33
1,0,0.5,0.5,false,false,200,300,195,295,-5,-5,5,false,false,false,-1.0
1,0,0.5,0.5,false,false,250,200,849,249,599,49,1,true,true,true,-1.0
1,0,0.5,0.5,false,false,250,250,250,250,0,0,0,true,true,true,-1.0
1,0,0.5,0.5,false,false,300,250,799,399,499,149,1,true,true,true,-1.0
1,0,0.5,0.5,false,false,250,250,247,247,-3,-3,3,true,true,true,-1.0
1,0,0.5,0.5,false,false,250,300,799,349,549,49,1,true,true,true,-1.0
1,0,0.5,0.5,false,false,300,200,300,200,0,0,0,true,true,true,-1.0
1,0,0.5,0.5,false,false,250,250,250,250,0,0,0,true,true,true,-1.0
1,0,0.5,0.5,false,false,850,250,847,247,-3,-3,3,true,true,true,-1.0
1,0,0.5,0.5,false,false,200,300,299,349,99,49,1,true,true,true,-1.0
1,0,0.5,0.5,false,false,300,250,347,297,47,47,3,true,true,true,-1.0
1,0,0.5,0.5,false,false,300,300,848,898,548,598,2,true,true,true,-1.0
1,0,0.5,0.5,false,false,850,250,850,250,0,0,0,true,true,true,-1.0
1,0,0.5,0.5,false,false,300,850,798,898,498,48,2,true,true,true,-1.0
1,0,0.5,0.5,false,false,250,300,245,295,-5,-5,5,true,true,true,-1.0
1,0,0.5,0.5,false,false,250,200,247,197,-3,-3,3,true,true,true,-1.0
1,0,0.5,0.5,false,false,850,200,845,195,-5,-5,5,true,true,true,-1.0
1,0,0.5,0.5,false,false,250,200,848,898,598,698,2,true,true,true,-1.0
1,0,0.5,0.5,false,false,300,850,297,847,-3,-3,3,true,true,true,-1.0
1,1,0.5,0.5,false,false,250,850,200,800,-50,-50,50,false,false,false,1.455
1,1,0.5,0.5,false,false,300,300,899,799,599,499,1,true,true,true,-1.0
1,1,0.5,0.5,false,false,250,850,247,847,-3,-3,3,true,true,true,-1.0
1,1,0.5,0.5,false,false,200,300,150,250,-50,-50,50,false,false,false,-1.0
1,1,0.5,0.5,false,false,200,850,150,800,-50,-50,50,true,true,true,-1.0
1,1,0.5,0.5,false,false,350,250,948,798,598,548,2,true,true,true,-1.0
1,1,0.5,0.5,false,false,200,250,150,200,-50,-50,50,false,false,false,-1.0
1,1,0.5,0.5,false,false,300,200,250,150,-50,-50,50,false,false,false,-1.0
1,1,0.5,0.5,false,false,850,300,800,250,-50,-50,50,true,true,true,-1.0
1,1,0.5,0.5,false,false,300,300,300,300,0,0,0,true,true,true,-1.0
1,1,0.5,0.5,false,false,200,350,899,899,699,549,1,true,true,true,-1.0
1,1,0.5,0.5,false,false,300,850,300,850,0,0,0,true,true,true,-1.0
1,1,0.5,0.5,false,false,300,850,250,800,-50,-50,50,true,true,true,-1.0
1,1,0.5,0.5,false,false,900,300,900,300,0,0,0,true,true,true,-1.0
1,1,0.5,0.5,false,false,350,900,350,900,0,0,0,true,true,true,-1.0
1,1,0.5,0.5,false,false,900,200,900,200,0,0,0,true,true,true,-1.0
1,1,0.5,0.5,false,false,250,300,899,799,649,499,1,true,true,true,-1.0
1,1,0.5,0.5,false,false,300,250,349,799,49,549,1,true,true,true,-1.0
1,1,0.5,0.5,false,false,300,850,250,800,-50,-50,50,true,true,true,-1.0
1,1,0.5,0.5,false,false,300,300,348,798,48,498,2,true,true,true,-1.0
1,2,0.5,0.5,false,true,200,350,198,348,-2,-2,2,true,true,true,659.642
1,2,0.5,0.5,false,true,350,200,348,198,-2,-2,2,true,true,true,-1.0
1,2,0.5,0.5,false,true,300,850,298,848,-2,-2,2,true,true,true,-1.0
1,2,0.5,0.5,false,true,300,250,348,798,48,548,2,true,true,true,-1.0
1,2,0.5,0.5,false,true,250,250,897,847,647,597,3,true,true,true,-1.0
1,2,0.5,0.5,false,true,900,300,898,298,-2,-2,2,true,true,true,-1.0
1,2,0.5,0.5,false,true,250,200,250,200,0,0,0,true,true,true,-1.0
1,2,0.5,0.5,false,true,250,850,248,848,-2,-2,2,true,true,true,-1.0
1,2,0.5,0.5,false,true,200,300,348,898,148,598,2,true,false,true,-1.0
1,2,0.5,0.5,false,true,350,250,350,250,0,0,0,true,true,true,-1.0
1,2,0.5,0.5,false,true,250,850,246,846,-4,-4,4,true,true,true,-1.0
1,2,0.5,0.5,false,true,850,350,848,348,-2,-2,2,true,true,true,-1.0
1,2,0.5,0.5,false,true,350,250,350,250,0,0,0,true,true,true,-1.0
1,2,0.5,0.5,false,true,850,300,848,298,-2,-2,2,true,true,true,-1.0
1,2,0.5,0.5,false,true,850,200,850,200,0,0,0,false,false,false,-1.0
1,2,0.5,0.5,false,true,350,300,399,799,49,499,1,true,true,true,-1.0
1,2,0.5,0.5,false,true,300,300,849,849,549,549,1,true,true,true,-1.0
1,2,0.5,0.5,false,true,300,250,250,200,-50,-50,50,false,false,false,-1.0
1,2,0.5,0.5,false,true,200,300,248,798,48,498,2,true,true,true,-1.0
1,2,0.5,0.5,false,true,200,250,249,299,49,49,1,true,true,true,-1.0
1,2,0.5,0.5,false,false,300,200,300,200,0,0,0,false,false,false,105.931
1,2,0.5,0.5,false,false,850,200,850,200,0,0,0,true,true,true,-1.0
1,2,0.5,0.5,false,false,300,300,777,327,477,27,23,true,true,true,-1.0
1,2,0.5,0.5,false,false,300,250,298,248,-2,-2,2,true,true,true,-1.0
1,2,0.5,0.5,false,false,250,300,799,349,549,49,1,true,true,true,-1.0
1,2,0.5,0.5,false,false,300,250,250,200,-50,-50,50,false,false,false,-1.0
1,2,0.5,0.5,false,false,300,200,799,949,499,749,1,true,true,true,-1.0
1,2,0.5,0.5,false,false,900,300,890,290,-10,-10,10,true,true,true,-1.0
1,2,0.5,0.5,false,false,300,250,297,247,-3,-3,3,true,true,true,-1.0
1,2,0.5,0.5,false,false,200,900,198,898,-2,-2,2,true,true,true,-1.0
1,2,0.5,0.5,false,false,350,350,342,342,-8,-8,8,true,true,true,-1.0
1,2,0.5,0.5,false,false,300,300,799,899,499,599,1,true,true,true,-1.0
1,2,0.5,0.5,false,false,350,250,348,248,-2,-2,2,true,true,true,-1.0
1,2,0.5,0.5,false,false,250,350,200,300,-50,-50,50,false,false,false,-1.0
1,2,0.5,0.5,false,false,250,300,398,798,148,498,2,true,true,true,-1.0
1,2,0.5,0.5,false,false,200,250,823,273,623,23,27,true,true,true,-1.0
1,2,0.5,0.5,false,false,200,850,198,848,-2,-2,2,true,true,true,-1.0
1,2,0.5,0.5,false,false,350,300,350,300,0,0,0,true,true,true,-1.0
1,2,0.5,0.5,false,false,350,200,300,150,-50,-50,50,false,false,false,-1.0
1,2,0.5,0.5,false,false,250,250,248,248,-2,-2,2,true,true,true,-1.0
2,0,0.5,0.5,true,false,200,300,249,349,49,49,1,true,true,true,679.458
2,0,0.5,0.5,true,false,200,200,197,197,-3,-3,3,true,true,true,-1.0
2,0,0.5,0.5,true,false,200,250,197,247,-3,-3,3,false,false,false,-1.0
2,0,0.5,0.5,true,false,300,350,295,345,-5,-5,5,true,true,true,-1.0
2,0,0.5,0.5,true,false,200,300,197,297,-3,-3,3,true,true,true,-1.0
2,0,0.5,0.5,true,false,300,300,797,347,497,47,3,true,true,true,-1.0
2,0,0.5,0.5,true,false,250,250,245,245,-5,-5,5,true,true,true,-1.0
2,0,0.5,0.5,true,false,850,850,850,850,0,0,0,true,true,true,-1.0
2,0,0.5,0.5,true,false,200,250,795,295,595,45,5,true,true,true,-1.0
2,0,0.5,0.5,true,false,250,250,245,245,-5,-5,5,true,true,true,-1.0
2,0,0.5,0.5,true,false,300,250,347,297,47,47,3,true,true,true,-1.0
2,0,0.5,0.5,true,false,200,200,297,247,97,47,3,true,true,true,-1.0
2,0,0.5,0.5,true,false,200,900,197,897,-3,-3,3,true,true,true,-1.0
2,0,0.5,0.5,true,false,250,300,247,297,-3,-3,3,true,true,true,-1.0
2,0,0.5,0.5,true,false,200,300,200,300,0,0,0,true,true,true,-1.0
2,0,0.5,0.5,true,false,200,200,197,197,-3,-3,3,true,true,true,-1.0
2,0,0.5,0.5,true,false,250,300,247,297,-3,-3,3,false,false,false,-1.0
2,0,0.5,0.5,true,false,250,300,247,297,-3,-3,3,true,true,true,-1.0
2,0,0.5,0.5,true,false,300,200,298,198,-2,-2,2,true,true,true,-1.0
2,0,0.5,0.5,true,false,300,300,300,300,0,0,0,true,true,true,-1.0
2,0,0.5,0.5,false,false,300,250,847,297,547,47,3,true,true,true,106.126
2,0,0.5,0.5,false,false,300,250,300,250,0,0,0,true,true,true,-1.0
2,0,0.5,0.5,false,false,200,250,197,247,-3,-3,3,true,true,true,-1.0
2,0,0.5,0.5,false,false,250,250,247,247,-3,-3,3,true,true,true,-1.0
2,0,0.5,0.5,false,false,850,850,847,847,-3,-3,3,true,true,true,-1.0
2,0,0.5,0.5,false,false,250,250,250,250,0,0,0,false,false,false,-1.0
2,0,0.5,0.5,false,false,900,300,900,300,0,0,0,true,true,true,-1.0
2,0,0.5,0.5,false,false,850,300,845,295,-5,-5,5,true,true,true,-1.0
2,0,0.5,0.5,false,false,200,300,197,297,-3,-3,3,true,true,true,-1.0
2,0,0.5,0.5,false,false,200,200,200,200,0,0,0,true,true,true,-1.0
2,0,0.5,0.5,false,false,300,300,297,297,-3,-3,3,true,true,true,-1.0
2,0,0.5,0.5,false,false,850,300,898,798,48,498,2,true,true,true,-1.0
2,0,0.5,0.5,false,false,250,350,296,896,46,546,4,true,true,true,-1.0
2,0,0.5,0.5,false,false,850,200,845,195,-5,-5,5,true,true,true,-1.0
2,0,0.5,0.5,false,false,300,350,300,350,0,0,0,true,true,true,-1.0
2,0,0.5,0.5,false,false,250,850,245,845,-5,-5,5,true,true,true,-1.0
2,0,0.5,0.5,false,false,250,900,247,897,-3,-3,3,true,true,true,-1.0
2,0,0.5,0.5,false,false,300,300,799,899,499,599,1,true,true,true,-1.0
2,0,0.5,0.5,false,false,300,250,897,847,597,597,3,true,true,true,-1.0
2,0,0.5,0.5,false,false,250,850,799,899,549,49,1,true,true,true,-1.0
2,1,0.5,0.5,true,false,300,300,297,297,-3,-3,3,true,true,true,1007.272
2,1,0.5,0.5,true,false,200,300,197,297,-3,-3,3,true,true,true,-1.0
2,1,0.5,0.5,true,false,350,850,347,847,-3,-3,3,true,true,true,-1.0
2,1,0.5,0.5,true,false,900,300,897,297,-3,-3,3,true,true,true,-1.0
2,1,0.5,0.5,true,false,250,250,278,878,28,628,22,true,true,true,-1.0
2,1,0.5,0.5,true,false,250,200,200,150,-50,-50,50,false,false,false,-1.0
2,1,0.5,0.5,true,false,300,850,299,899,-1,49,1,true,true,true,-1.0
2,1,0.5,0.5,true,false,200,300,150,250,-50,-50,50,false,false,false,-1.0
2,1,0.5,0.5,true,false,250,250,797,297,547,47,3,true,false,true,-1.0
2,1,0.5,0.5,true,false,200,250,799,299,599,49,1,true,true,true,-1.0
2,1,0.5,0.5,true,false,300,300,297,297,-3,-3,3,true,true,true,-1.0
2,1,0.5,0.5,true,false,200,300,899,849,699,549,1,true,true,true,-1.0
2,1,0.5,0.5,true,false,850,300,899,799,49,499,1,true,true,true,-1.0
2,1,0.5,0.5,true,false,350,200,350,200,0,0,0,true,true,true,-1.0
2,1,0.5,0.5,true,false,900,850,900,850,0,0,0,true,true,true,-1.0
2,1,0.5,0.5,true,false,250,200,339,239,89,39,11,true,true,true,-1.0
2,1,0.5,0.5,true,false,300,250,300,250,0,0,0,true,true,true,-1.0
2,1,0.5,0.5,true,false,250,250,247,247,-3,-3,3,false,false,false,-1.0
2,1,0.5,0.5,true,false,300,300,797,897,497,597,3,true,true,true,-1.0
2,1,0.5,0.5,true,false,850,300,838,288,-12,-12,12,true,true,true,-1.0
2,1,0.5,0.5,false,false,300,200,797,397,497,197,3,true,true,true,125.209
2,1,0.5,0.5,false,false,300,200,348,298,48,98,2,true,true,true,-1.0
2,1,0.5,0.5,false,false,300,300,250,250,-50,-50,50,false,false,false,-1.0
2,1,0.5,0.5,false,false,300,200,796,896,496,696,4,true,true,true,-1.0
2,1,0.5,0.5,false,false,850,250,850,250,0,0,0,true,true,true,-1.0
2,1,0.5,0.5,false,false,850,250,847,247,-3,-3,3,true,true,true,-1.0
2,1,0.5,0.5,false,false,250,250,250,250,0,0,0,true,true,true,-1.0
2,1,0.5,0.5,false,false,250,900,247,897,-3,-3,3,true,true,true,-1.0
2,1,0.5,0.5,false,false,250,850,247,847,-3,-3,3,true,true,true,-1.0
2,1,0.5,0.5,false,false,250,300,249,299,-1,-1,1,true,true,true,-1.0
2,1,0.5,0.5,false,false,300,300,798,898,498,598,2,true,true,true,-1.0
2,1,0.5,0.5,false,false,350,250,399,299,49,49,1,true,true,true,-1.0
2,1,0.5,0.5,false,false,250,850,247,847,-3,-3,3,true,true,true,-1.0
2,1,0.5,0.5,false,false,350,300,347,297,-3,-3,3,true,true,true,-1.0
2,1,0.5,0.5,false,false,300,200,300,200,0,0,0,true,true,true,-1.0
2,1,0.5,0.5,false,false,850,300,849,299,-1,-1,1,true,true,true,-1.0
2,1,0.5,0.5,false,false,200,250,249,799,49,549,1,true,true,true,-1.0
2,1,0.5,0.5,false,false,200,200,197,197,-3,-3,3,true,true,true,-1.0
2,1,0.5,0.5,false,false,850,250,898,798,48,548,2,true,true,true,-1.0
2,1,0.5,0.5,false,false,200,250,249,799,49,549,1,true,true,true,-1.0
2,2,0.5,0.5,true,true,300,900,300,900,0,0,0,true,true,true,666.584
2,2,0.5,0.5,true,true,250,250,299,299,49,49,1,true,true,true,-1.0
2,2,0.5,0.5,true,true,200,200,198,198,-2,-2,2,true,true,true,-1.0
2,2,0.5,0.5,true,true,250,850,250,850,0,0,0,true,true,true,-1.0
2,2,0.5,0.5,true,true,200,200,899,849,699,649,1,true,true,true,-1.0
2,2,0.5,0.5,true,true,350,300,350,300,0,0,0,true,true,true,-1.0
2,2,0.5,0.5,true,true,250,200,849,249,599,49,1,false,false,true,-1.0
2,2,0.5,0.5,true,true,850,200,850,200,0,0,0,true,true,true,-1.0
2,2,0.5,0.5,true,true,300,850,298,848,-2,-2,2,true,true,true,-1.0
2,2,0.5,0.5,true,true,250,300,342,792,92,492,8,true,true,true,-1.0
2,2,0.5,0.5,true,true,300,850,799,899,499,49,1,true,true,true,-1.0
2,2,0.5,0.5,true,true,250,250,797,347,547,97,3,true,true,true,-1.0
2,2,0.5,0.5,true,true,350,200,349,199,-1,-1,1,true,true,true,-1.0
2,2,0.5,0.5,true,true,900,250,899,249,-1,-1,1,true,true,true,-1.0
2,2,0.5,0.5,true,true,900,250,949,799,49,549,1,true,true,true,-1.0
2,2,0.5,0.5,true,true,250,300,248,298,-2,-2,2,true,true,true,-1.0
2,2,0.5,0.5,true,true,250,200,299,249,49,49,1,true,true,true,-1.0
2,2,0.5,0.5,true,true,200,850,798,898,598,48,2,true,true,true,-1.0
2,2,0.5,0.5,true,true,300,250,299,249,-1,-1,1,true,true,true,-1.0
2,2,0.5,0.5,true,true,350,350,899,899,549,549,1,true,true,true,-1.0
2,2,0.5,0.5,true,false,850,300,898,798,48,498,2,true,true,true,496.496
2,2,0.5,0.5,true,false,350,850,349,849,-1,-1,1,true,true,true,-1.0
2,2,0.5,0.5,true,false,850,200,850,200,0,0,0,true,true,true,-1.0
2,2,0.5,0.5,true,false,250,200,299,249,49,49,1,true,true,true,-1.0
2,2,0.5,0.5,true,false,300,200,349,799,49,599,1,true,true,true,-1.0
2,2,0.5,0.5,true,false,250,350,298,898,48,548,2,true,true,true,-1.0
2,2,0.5,0.5,true,false,850,300,849,299,-1,-1,1,true,true,true,-1.0
2,2,0.5,0.5,true,false,200,200,200,200,0,0,0,true,true,true,-1.0
2,2,0.5,0.5,true,false,300,200,798,248,498,48,2,true,true,true,-1.0
2,2,0.5,0.5,true,false,350,300,349,299,-1,-1,1,true,true,true,-1.0
2,2,0.5,0.5,true,false,300,850,299,849,-1,-1,1,true,true,true,-1.0
2,2,0.5,0.5,true,false,300,350,799,399,499,49,1,true,true,true,-1.0
2,2,0.5,0.5,true,false,300,300,799,349,499,49,1,true,true,true,-1.0
2,2,0.5,0.5,true,false,850,300,847,297,-3,-3,3,true,true,true,-1.0
2,2,0.5,0.5,true,false,850,850,850,850,0,0,0,true,true,true,-1.0
2,2,0.5,0.5,true,false,250,300,200,250,-50,-50,50,false,false,false,-1.0
2,2,0.5,0.5,true,false,250,300,799,349,549,49,1,true,true,true,-1.0
2,2,0.5,0.5,true,false,300,300,300,300,0,0,0,true,true,true,-1.0
2,2,0.5,0.5,true,false,300,350,899,899,599,549,1,true,true,true,-1.0
2,2,0.5,0.5,true,false,300,200,798,298,498,98,2,true,true,true,-1.0
2,2,0.5,0.5,false,true,850,900,850,900,0,0,0,true,true,true,442.494
2,2,0.5,0.5,false,true,300,850,299,849,-1,-1,1,true,true,true,-1.0
2,2,0.5,0.5,false,true,850,850,849,849,-1,-1,1,true,true,true,-1.0
2,2,0.5,0.5,false,true,300,350,299,349,-1,-1,1,true,true,true,-1.0
2,2,0.5,0.5,false,true,250,250,250,250,0,0,0,true,true,true,-1.0
2,2,0.5,0.5,false,true,200,250,198,248,-2,-2,2,true,true,true,-1.0
2,2,0.5,0.5,false,true,250,300,250,300,0,0,0,true,true,true,-1.0
2,2,0.5,0.5,false,true,250,350,250,350,0,0,0,true,true,true,-1.0
2,2,0.5,0.5,false,true,250,250,249,249,-1,-1,1,true,true,true,-1.0
2,2,0.5,0.5,false,true,300,350,898,898,598,548,2,true,true,true,-1.0
2,2,0.5,0.5,false,true,200,250,898,898,698,648,2,true,true,true,-1.0
2,2,0.5,0.5,false,true,250,850,248,848,-2,-2,2,true,true,true,-1.0
2,2,0.5,0.5,false,true,300,300,299,299,-1,-1,1,true,true,true,-1.0
2,2,0.5,0.5,false,true,350,200,350,200,0,0,0,true,true,true,-1.0
2,2,0.5,0.5,false,true,200,850,799,899,599,49,1,true,true,true,-1.0
2,2,0.5,0.5,false,true,200,200,200,200,0,0,0,true,true,true,-1.0
2,2,0.5,0.5,false,true,200,250,248,348,48,98,2,true,true,true,-1.0
2,2,0.5,0.5,false,true,350,250,898,298,548,48,2,true,true,true,-1.0
2,2,0.5,0.5,false,true,300,250,798,298,498,48,2,true,true,true,-1.0
2,2,0.5,0.5,false,true,200,300,200,300,0,0,0,true,true,true,-1.0
2,2,0.5,0.5,false,false,350,300,350,300,0,0,0,true,true,true,95.558
2,2,0.5,0.5,false,false,850,300,899,799,49,499,1,true,true,true,-1.0
2,2,0.5,0.5,false,false,250,850,798,898,548,48,2,true,true,true,-1.0
2,2,0.5,0.5,false,false,200,300,197,297,-3,-3,3,true,true,true,-1.0
2,2,0.5,0.5,false,false,250,850,249,849,-1,-1,1,true,true,true,-1.0
2,2,0.5,0.5,false,false,200,300,248,848,48,548,2,true,true,true,-1.0
2,2,0.5,0.5,false,false,850,350,850,350,0,0,0,true,true,true,-1.0
2,2,0.5,0.5,false,false,250,300,246,296,-4,-4,4,true,true,true,-1.0
2,2,0.5,0.5,false,false,200,250,298,798,98,548,2,true,true,true,-1.0
2,2,0.5,0.5,false,false,200,850,798,898,598,48,2,true,true,true,-1.0
2,2,0.5,0.5,false,false,300,200,300,200,0,0,0,true,true,true,-1.0
2,2,0.5,0.5,false,false,850,200,899,299,49,99,1,true,true,true,-1.0
2,2,0.5,0.5,false,false,300,300,898,798,598,498,2,true,true,true,-1.0
2,2,0.5,0.5,false,false,300,250,398,798,98,548,2,true,true,true,-1.0
2,2,0.5,0.5,false,false,300,300,798,348,498,48,2,true,true,true,-1.0
2,2,0.5,0.5,false,false,300,850,299,849,-1,-1,1,true,true,true,-1.0
2,2,0.5,0.5,false,false,250,350,348,898,98,548,2,true,true,true,-1.0
2,2,0.5,0.5,false,false,300,300,848,848,548,548,2,true,true,true,-1.0
2,2,0.5,0.5,false,false,350,300,349,299,-1,-1,1,true,true,true,-1.0
2,2,0.5,0.5,false,false,250,900,249,899,-1,-1,1,true,true,true,-1.0
0,0,0.5,0.5,false,false,200,300,298,798,98,498,2,true,false,true,0.203
0,0,0.5,0.5,false,false,300,300,899,849,599,549,1,true,true,true,-1.0
0,0,0.5,0.5,false,false,300,850,297,847,-3,-3,3,true,true,true,-1.0
0,0,0.5,0.5,false,false,300,250,296,246,-4,-4,4,false,false,false,-1.0
0,0,0.5,0.5,false,false,350,350,346,346,-4,-4,4,true,true,true,-1.0
0,0,0.5,0.5,false,false,250,300,298,798,48,498,2,true,true,true,-1.0
0,0,0.5,0.5,false,false,850,300,846,296,-4,-4,4,true,true,true,-1.0
0,0,0.5,0.5,false,false,300,850,298,848,-2,-2,2,true,true,true,-1.0
0,0,0.5,0.5,false,false,850,250,847,247,-3,-3,3,true,true,true,-1.0
0,0,0.5,0.5,false,false,850,250,846,246,-4,-4,4,true,true,true,-1.0
0,0,0.5,0.5,false,false,250,300,346,796,96,496,4,true,true,true,-1.0
0,0,0.5,0.5,false,false,300,250,297,247,-3,-3,3,true,true,true,-1.0
0,0,0.5,0.5,false,false,350,200,897,247,547,47,3,true,true,true,-1.0
0,0,0.5,0.5,false,false,300,200,797,347,497,147,3,true,true,true,-1.0
0,0,0.5,0.5,false,false,850,300,848,298,-2,-2,2,true,true,true,-1.0
0,0,0.5,0.5,false,false,250,850,247,847,-3,-3,3,true,true,true,-1.0
0,0,0.5,0.5,false,false,350,200,398,798,48,598,2,true,true,true,-1.0
0,0,0.5,0.5,false,false,250,200,298,798,48,598,2,true,true,true,-1.0
0,0,0.5,0.5,false,false,200,850,298,898,98,48,2,true,true,true,-1.0
0,0,0.5,0.5,false,false,850,850,847,847,-3,-3,3,true,true,true,-1.0
0,1,0.5,0.5,false,false,200,250,248,298,48,48,2,true,false,true,0.322
0,1,0.5,0.5,false,false,350,300,346,296,-4,-4,4,true,true,true,-1.0
0,1,0.5,0.5,false,false,300,250,348,798,48,548,2,true,true,true,-1.0
0,1,0.5,0.5,false,false,350,300,897,847,547,547,3,true,true,true,-1.0
0,1,0.5,0.5,false,false,250,850,246,846,-4,-4,4,true,true,true,-1.0
0,1,0.5,0.5,false,false,850,300,898,798,48,498,2,true,true,true,-1.0
0,1,0.5,0.5,false,false,300,300,348,898,48,598,2,true,true,true,-1.0
0,1,0.5,0.5,false,false,200,900,248,948,48,48,2,true,true,true,-1.0
0,1,0.5,0.5,false,false,250,200,246,196,-4,-4,4,false,false,false,-1.0
0,1,0.5,0.5,false,false,250,300,298,798,48,498,2,true,false,true,-1.0
0,1,0.5,0.5,false,false,250,300,298,798,48,498,2,true,true,true,-1.0
0,1,0.5,0.5,false,false,250,250,949,799,699,549,1,true,true,true,-1.0
0,1,0.5,0.5,false,false,250,350,298,898,48,548,2,true,true,true,-1.0
0,1,0.5,0.5,false,false,250,850,246,846,-4,-4,4,true,true,true,-1.0
0,1,0.5,0.5,false,false,250,250,348,798,98,548,2,true,true,true,-1.0
0,1,0.5,0.5,false,false,200,850,298,898,98,48,2,true,true,true,-1.0
0,1,0.5,0.5,false,false,300,250,348,798,48,548,2,true,true,true,-1.0
0,1,0.5,0.5,false,false,250,250,298,298,48,48,2,true,true,true,-1.0
0,1,0.5,0.5,false,false,300,300,848,898,548,598,2,true,true,true,-1.0
0,1,0.5,0.5,false,false,350,200,346,196,-4,-4,4,false,false,false,-1.0
0,2,0.5,0.5,false,true,250,300,246,296,-4,-4,4,true,true,true,461.093
0,2,0.5,0.5,false,true,350,300,346,296,-4,-4,4,true,true,true,-1.0
0,2,0.5,0.5,false,true,300,300,799,349,499,49,1,true,true,true,-1.0
0,2,0.5,0.5,false,true,200,300,199,299,-1,-1,1,true,true,true,-1.0
0,2,0.5,0.5,false,true,250,300,298,898,48,598,2,true,false,true,-1.0
0,2,0.5,0.5,false,true,250,300,298,848,48,548,2,true,true,true,-1.0
0,2,0.5,0.5,false,true,250,200,248,198,-2,-2,2,false,false,false,-1.0
0,2,0.5,0.5,false,true,250,250,246,246,-4,-4,4,true,true,true,-1.0
0,2,0.5,0.5,false,true,300,350,799,949,499,599,1,true,true,true,-1.0
0,2,0.5,0.5,false,true,250,250,247,247,-3,-3,3,true,true,true,-1.0
0,2,0.5,0.5,false,true,300,850,799,899,499,49,1,true,true,true,-1.0
0,2,0.5,0.5,false,true,200,350,298,898,98,548,2,true,true,true,-1.0
0,2,0.5,0.5,false,true,850,200,846,196,-4,-4,4,true,true,true,-1.0
0,2,0.5,0.5,false,true,850,200,848,198,-2,-2,2,true,true,true,-1.0
0,2,0.5,0.5,false,true,250,300,246,296,-4,-4,4,true,true,true,-1.0
0,2,0.5,0.5,false,true,900,300,896,296,-4,-4,4,true,true,true,-1.0
0,2,0.5,0.5,false,true,250,250,298,898,48,648,2,false,false,true,-1.0
0,2,0.5,0.5,false,true,850,200,847,197,-3,-3,3,true,true,true,-1.0
0,2,0.5,0.5,false,true,850,200,898,798,48,598,2,true,true,true,-1.0
0,2,0.5,0.5,false,true,200,200,199,199,-1,-1,1,true,true,true,-1.0
0,2,0.5,0.5,false,false,850,850,846,846,-4,-4,4,true,true,true,80.706
0,2,0.5,0.5,false,false,850,300,898,798,48,498,2,true,true,true,-1.0
0,2,0.5,0.5,false,false,300,300,296,296,-4,-4,4,false,false,false,-1.0
0,2,0.5,0.5,false,false,300,850,297,847,-3,-3,3,true,true,true,-1.0
0,2,0.5,0.5,false,false,250,300,246,296,-4,-4,4,true,true,true,-1.0
0,2,0.5,0.5,false,false,200,300,199,299,-1,-1,1,true,true,true,-1.0
0,2,0.5,0.5,false,false,350,250,346,246,-4,-4,4,true,true,true,-1.0
0,2,0.5,0.5,false,false,300,350,296,346,-4,-4,4,true,true,true,-1.0
0,2,0.5,0.5,false,false,850,200,846,196,-4,-4,4,false,false,false,-1.0
0,2,0.5,0.5,false,false,300,250,296,246,-4,-4,4,true,true,true,-1.0
0,2,0.5,0.5,false,false,300,200,799,249,499,49,1,true,true,true,-1.0
0,2,0.5,0.5,false,false,300,300,297,297,-3,-3,3,true,true,true,-1.0
0,2,0.5,0.5,false,false,300,850,296,846,-4,-4,4,true,true,true,-1.0
0,2,0.5,0.5,false,false,300,300,348,798,48,498,2,true,true,true,-1.0
0,2,0.5,0.5,false,false,850,200,846,196,-4,-4,4,true,true,true,-1.0
0,2,0.5,0.5,false,false,200,850,799,899,599,49,1,true,true,true,-1.0
0,2,0.5,0.5,false,false,300,850,798,898,498,48,2,true,true,true,-1.0
0,2,0.5,0.5,false,false,250,200,296,796,46,596,4,true,true,true,-1.0
0,2,0.5,0.5,false,false,300,900,297,897,-3,-3,3,true,true,true,-1.0
0,2,0.5,0.5,false,false,900,300,897,297,-3,-3,3,true,true,true,-1.0
1,0,0.5,0.5,false,false,250,250,247,247,-3,-3,3,true,true,true,0.359
1,0,0.5,0.5,false,false,850,850,847,847,-3,-3,3,true,true,true,-1.0
1,0,0.5,0.5,false,false,250,850,247,847,-3,-3,3,true,true,true,-1.0
1,0,0.5,0.5,false,false,350,300,347,297,-3,-3,3,true,true,true,-1.0
1,0,0.5,0.5,false,false,300,200,300,200,0,0,0,true,true,true,-1.0
1,0,0.5,0.5,false,false,200,350,197,347,-3,-3,3,true,true,true,-1.0
1,0,0.5,0.5,false,false,300,300,297,297,-3,-3,3,true,true,true,-1.0
1,0,0.5,0.5,false,false,300,250,847,297,547,47,3,true,true,true,-1.0
1,0,0.5,0.5,false,false,200,250,197,247,-3,-3,3,true,true,true,-1.0
1,0,0.5,0.5,false,false,300,850,297,847,-3,-3,3,true,true,true,-1.0
1,0,0.5,0.5,false,false,850,300,847,297,-3,-3,3,true,true,true,-1.0
1,0,0.5,0.5,false,false,300,300,798,798,498,498,2,true,true,true,-1.0
1,0,0.5,0.5,false,false,250,200,250,200,0,0,0,true,true,true,-1.0
1,0,0.5,0.5,false,false,850,300,850,300,0,0,0,true,true,true,-1.0
1,0,0.5,0.5,false,false,300,250,349,799,49,549,1,true,true,true,-1.0
1,0,0.5,0.5,false,false,300,300,799,949,499,649,1,true,true,true,-1.0
1,0,0.5,0.5,false,false,300,300,349,799,49,499,1,true,true,true,-1.0
1,0,0.5,0.5,false,false,250,200,898,298,648,98,2,true,true,true,-1.0
1,0,0.5,0.5,false,false,300,350,797,397,497,47,3,true,true,true,-1.0
1,0,0.5,0.5,false,false,300,300,297,297,-3,-3,3,true,true,true,-1.0
1,1,0.5,0.5,false,false,200,300,150,250,-50,-50,50,true,true,true,1.397
1,1,0.5,0.5,false,false,850,900,850,900,0,0,0,true,true,true,-1.0
1,1,0.5,0.5,false,false,300,300,849,849,549,549,1,true,true,true,-1.0
1,1,0.5,0.5,false,false,200,850,197,847,-3,-3,3,true,true,true,-1.0
1,1,0.5,0.5,false,false,250,200,250,200,0,0,0,true,true,true,-1.0
1,1,0.5,0.5,false,false,250,250,299,799,49,549,1,true,true,true,-1.0
1,1,0.5,0.5,false,false,250,200,200,150,-50,-50,50,false,false,false,-1.0
1,1,0.5,0.5,false,false,250,200,250,200,0,0,0,true,true,true,-1.0
1,1,0.5,0.5,false,false,300,250,797,297,497,47,3,true,true,true,-1.0
1,1,0.5,0.5,false,false,300,300,250,250,-50,-50,50,true,true,true,-1.0
1,1,0.5,0.5,false,false,300,250,899,299,599,49,1,true,true,true,-1.0
1,1,0.5,0.5,false,false,300,200,296,196,-4,-4,4,true,true,true,-1.0
1,1,0.5,0.5,false,false,250,250,298,798,48,548,2,true,true,true,-1.0
1,1,0.5,0.5,false,false,200,850,197,847,-3,-3,3,true,true,true,-1.0
1,1,0.5,0.5,false,false,250,300,298,798,48,498,2,true,true,true,-1.0
1,1,0.5,0.5,false,false,200,250,197,247,-3,-3,3,true,true,true,-1.0
1,1,0.5,0.5,false,false,300,350,250,300,-50,-50,50,false,false,false,-1.0
1,1,0.5,0.5,false,false,350,850,300,800,-50,-50,50,true,true,true,-1.0
1,1,0.5,0.5,false,false,250,200,849,899,599,699,1,true,true,true,-1.0
1,1,0.5,0.5,false,false,250,300,247,297,-3,-3,3,true,true,true,-1.0
1,2,0.5,0.5,false,true,200,200,799,899,599,699,1,true,true,true,579.717
1,2,0.5,0.5,false,true,200,250,200,250,0,0,0,true,true,true,-1.0
1,2,0.5,0.5,false,true,200,300,198,298,-2,-2,2,true,true,true,-1.0
1,2,0.5,0.5,false,true,200,300,798,948,598,648,2,true,true,true,-1.0
1,2,0.5,0.5,false,true,850,250,848,248,-2,-2,2,true,true,true,-1.0
1,2,0.5,0.5,false,true,200,250,299,299,99,49,1,true,true,true,-1.0
1,2,0.5,0.5,false,true,300,200,300,200,0,0,0,true,true,true,-1.0
1,2,0.5,0.5,false,true,300,200,298,198,-2,-2,2,true,true,true,-1.0
1,2,0.5,0.5,false,true,200,250,299,299,99,49,1,true,true,true,-1.0
1,2,0.5,0.5,false,true,300,250,848,898,548,648,2,true,true,true,-1.0
1,2,0.5,0.5,false,true,250,300,248,298,-2,-2,2,true,true,true,-1.0
1,2,0.5,0.5,false,true,300,200,300,200,0,0,0,false,false,false,-1.0
1,2,0.5,0.5,false,true,850,900,849,899,-1,-1,1,true,true,true,-1.0
1,2,0.5,0.5,false,true,350,350,348,348,-2,-2,2,true,true,true,-1.0
1,2,0.5,0.5,false,true,200,300,198,298,-2,-2,2,true,true,true,-1.0
1,2,0.5,0.5,false,true,850,300,848,298,-2,-2,2,true,true,true,-1.0
1,2,0.5,0.5,false,true,900,850,900,850,0,0,0,true,true,true,-1.0
1,2,0.5,0.5,false,true,300,350,298,348,-2,-2,2,true,true,true,-1.0
1,2,0.5,0.5,false,true,200,850,199,849,-1,-1,1,true,true,true,-1.0
1,2,0.5,0.5,false,true,250,300,248,298,-2,-2,2,true,true,true,-1.0
1,2,0.5,0.5,false,false,250,300,248,298,-2,-2,2,true,true,true,89.114
1,2,0.5,0.5,false,false,250,850,799,899,549,49,1,true,true,true,-1.0
1,2,0.5,0.5,false,false,250,250,248,248,-2,-2,2,true,true,true,-1.0
1,2,0.5,0.5,false,false,200,300,199,299,-1,-1,1,true,true,true,-1.0
1,2,0.5,0.5,false,false,250,350,248,348,-2,-2,2,true,true,true,-1.0
1,2,0.5,0.5,false,false,300,300,298,298,-2,-2,2,true,true,true,-1.0
1,2,0.5,0.5,false,false,250,300,299,799,49,499,1,true,true,true,-1.0
1,2,0.5,0.5,false,false,900,300,900,300,0,0,0,true,true,true,-1.0
1,2,0.5,0.5,false,false,300,300,799,899,499,599,1,true,true,true,-1.0
1,2,0.5,0.5,false,false,250,300,250,300,0,0,0,true,true,true,-1.0
1,2,0.5,0.5,false,false,250,200,248,198,-2,-2,2,true,true,true,-1.0
1,2,0.5,0.5,false,false,250,300,348,798,98,498,2,true,true,true,-1.0
1,2,0.5,0.5,false,false,200,300,759,309,559,9,41,true,true,true,-1.0
1,2,0.5,0.5,false,false,250,200,299,299,49,99,1,true,true,true,-1.0
1,2,0.5,0.5,false,false,200,200,199,199,-1,-1,1,true,true,true,-1.0
1,2,0.5,0.5,false,false,200,350,199,349,-1,-1,1,true,true,true,-1.0
1,2,0.5,0.5,false,false,300,250,331,281,31,31,19,true,true,true,-1.0
1,2,0.5,0.5,false,false,250,250,200,200,-50,-50,50,false,false,false,-1.0
1,2,0.5,0.5,false,false,300,250,323,273,23,23,27,true,true,true,-1.0
1,2,0.5,0.5,false,false,200,300,198,298,-2,-2,2,true,true,true,-1.0
2,0,0.5,0.5,true,false,300,850,799,899,499,49,1,true,true,true,564.005
2,0,0.5,0.5,true,false,200,200,197,197,-3,-3,3,true,true,true,-1.0
2,0,0.5,0.5,true,false,250,250,250,250,0,0,0,true,true,true,-1.0
2,0,0.5,0.5,true,false,300,200,397,247,97,47,3,true,true,true,-1.0
2,0,0.5,0.5,true,false,250,200,248,198,-2,-2,2,true,true,true,-1.0
2,0,0.5,0.5,true,false,300,350,295,345,-5,-5,5,true,true,true,-1.0
2,0,0.5,0.5,true,false,850,900,847,897,-3,-3,3,true,true,true,-1.0
2,0,0.5,0.5,true,false,200,250,298,798,98,548,2,true,true,true,-1.0
2,0,0.5,0.5,true,false,200,300,797,347,597,47,3,true,true,true,-1.0
2,0,0.5,0.5,true,false,850,300,899,799,49,499,1,true,true,true,-1.0
2,0,0.5,0.5,true,false,250,300,296,796,46,496,4,true,true,true,-1.0
2,0,0.5,0.5,true,false,300,250,349,799,49,549,1,true,true,true,-1.0
2,0,0.5,0.5,true,false,300,250,349,799,49,549,1,true,true,true,-1.0
2,0,0.5,0.5,true,false,300,250,947,297,647,47,3,true,true,true,-1.0
2,0,0.5,0.5,true,false,850,850,847,847,-3,-3,3,true,true,true,-1.0
2,0,0.5,0.5,true,false,200,850,197,847,-3,-3,3,true,true,true,-1.0
2,0,0.5,0.5,true,false,250,850,247,847,-3,-3,3,false,false,false,-1.0
2,0,0.5,0.5,true,false,250,350,245,345,-5,-5,5,false,false,false,-1.0
2,0,0.5,0.5,true,false,300,200,295,195,-5,-5,5,true,true,true,-1.0
2,0,0.5,0.5,true,false,300,250,898,798,598,548,2,true,true,true,-1.0
2,0,0.5,0.5,false,false,200,250,197,247,-3,-3,3,true,true,true,111.797
2,0,0.5,0.5,false,false,300,200,300,200,0,0,0,true,true,true,-1.0
2,0,0.5,0.5,false,false,850,350,845,345,-5,-5,5,true,true,true,-1.0
2,0,0.5,0.5,false,false,850,200,897,247,47,47,3,true,true,true,-1.0
2,0,0.5,0.5,false,false,200,300,197,297,-3,-3,3,false,false,false,-1.0
2,0,0.5,0.5,false,false,250,850,247,847,-3,-3,3,true,true,true,-1.0
2,0,0.5,0.5,false,false,200,250,197,247,-3,-3,3,true,true,true,-1.0
2,0,0.5,0.5,false,false,300,200,797,247,497,47,3,true,true,true,-1.0
2,0,0.5,0.5,false,false,300,300,297,297,-3,-3,3,true,true,true,-1.0
2,0,0.5,0.5,false,false,300,250,397,297,97,47,3,true,true,true,-1.0
2,0,0.5,0.5,false,false,250,300,797,397,547,97,3,true,true,true,-1.0
2,0,0.5,0.5,false,false,300,850,297,847,-3,-3,3,true,true,true,-1.0
2,0,0.5,0.5,false,false,250,850,250,850,0,0,0,true,true,true,-1.0
2,0,0.5,0.5,false,false,300,250,295,245,-5,-5,5,true,true,true,-1.0
2,0,0.5,0.5,false,false,300,200,897,247,597,47,3,true,true,true,-1.0
2,0,0.5,0.5,false,false,900,850,900,850,0,0,0,true,true,true,-1.0
2,0,0.5,0.5,false,false,250,200,250,200,0,0,0,true,true,true,-1.0
2,0,0.5,0.5,false,false,250,300,398,798,148,498,2,true,true,true,-1.0
2,0,0.5,0.5,false,false,250,250,799,299,549,49,1,true,true,true,-1.0
2,0,0.5,0.5,false,false,250,250,247,247,-3,-3,3,true,true,true,-1.0
2,1,0.5,0.5,true,false,850,300,847,297,-3,-3,3,true,true,true,993.358
2,1,0.5,0.5,true,false,200,850,197,847,-3,-3,3,true,true,true,-1.0
2,1,0.5,0.5,true,false,200,300,150,250,-50,-50,50,false,false,false,-1.0
2,1,0.5,0.5,true,false,200,300,197,297,-3,-3,3,true,true,true,-1.0
2,1,0.5,0.5,true,false,900,300,899,299,-1,-1,1,true,true,true,-1.0
2,1,0.5,0.5,true,false,200,300,199,299,-1,-1,1,true,true,true,-1.0
2,1,0.5,0.5,true,false,350,250,347,247,-3,-3,3,true,true,true,-1.0
2,1,0.5,0.5,true,false,200,250,797,347,597,97,3,true,true,true,-1.0
2,1,0.5,0.5,true,false,200,300,248,798,48,498,2,true,true,true,-1.0
2,1,0.5,0.5,true,false,250,200,247,197,-3,-3,3,true,true,true,-1.0
2,1,0.5,0.5,true,false,200,200,197,197,-3,-3,3,true,true,true,-1.0
2,1,0.5,0.5,true,false,250,300,349,899,99,599,1,true,true,true,-1.0
2,1,0.5,0.5,true,false,850,850,847,847,-3,-3,3,true,true,true,-1.0
2,1,0.5,0.5,true,false,250,250,798,298,548,48,2,true,true,true,-1.0
2,1,0.5,0.5,true,false,300,300,297,297,-3,-3,3,true,true,true,-1.0
2,1,0.5,0.5,true,false,300,200,899,249,599,49,1,true,true,true,-1.0
2,1,0.5,0.5,true,false,300,350,297,347,-3,-3,3,true,true,true,-1.0
2,1,0.5,0.5,true,false,300,850,300,850,0,0,0,true,true,true,-1.0
2,1,0.5,0.5,true,false,350,250,347,247,-3,-3,3,true,true,true,-1.0
2,1,0.5,0.5,true,false,200,300,199,299,-1,-1,1,true,true,true,-1.0
2,1,0.5,0.5,false,false,300,200,348,798,48,598,2,true,true,true,127.772
2,1,0.5,0.5,false,false,250,200,348,898,98,698,2,true,true,true,-1.0
2,1,0.5,0.5,false,false,300,250,897,847,597,597,3,true,true,true,-1.0
2,1,0.5,0.5,false,false,300,300,299,299,-1,-1,1,true,true,true,-1.0
2,1,0.5,0.5,false,false,300,300,300,300,0,0,0,true,true,true,-1.0
2,1,0.5,0.5,false,false,300,850,297,847,-3,-3,3,true,true,true,-1.0
2,1,0.5,0.5,false,false,300,300,349,799,49,499,1,true,true,true,-1.0
2,1,0.5,0.5,false,false,300,200,798,348,498,148,2,true,true,true,-1.0
2,1,0.5,0.5,false,false,300,250,898,798,598,548,2,true,true,true,-1.0
2,1,0.5,0.5,false,false,250,850,247,847,-3,-3,3,true,true,true,-1.0
2,1,0.5,0.5,false,false,300,250,797,297,497,47,3,true,true,true,-1.0
2,1,0.5,0.5,false,false,250,300,249,299,-1,-1,1,false,false,false,-1.0
2,1,0.5,0.5,false,false,250,250,798,298,548,48,2,true,true,true,-1.0
2,1,0.5,0.5,false,false,900,900,900,900,0,0,0,true,true,true,-1.0
2,1,0.5,0.5,false,false,250,900,235,885,-15,-15,15,true,true,true,-1.0
2,1,0.5,0.5,false,false,250,300,260,310,10,10,40,true,true,true,-1.0
2,1,0.5,0.5,false,false,200,900,236,936,36,36,14,true,true,true,-1.0
2,1,0.5,0.5,false,false,250,300,797,347,547,47,3,true,true,true,-1.0
2,1,0.5,0.5,false,false,850,850,849,849,-1,-1,1,true,true,true,-1.0
2,1,0.5,0.5,false,false,250,250,247,247,-3,-3,3,true,true,true,-1.0
2,2,0.5,0.5,true,true,300,250,298,248,-2,-2,2,true,true,true,566.115
2,2,0.5,0.5,true,true,850,350,849,349,-1,-1,1,true,true,true,-1.0
2,2,0.5,0.5,true,true,250,850,249,849,-1,-1,1,true,true,true,-1.0
2,2,0.5,0.5,true,true,200,300,199,299,-1,-1,1,true,true,true,-1.0
2,2,0.5,0.5,true,true,300,900,300,900,0,0,0,true,true,true,-1.0
2,2,0.5,0.5,true,true,250,850,246,846,-4,-4,4,true,true,true,-1.0
2,2,0.5,0.5,true,true,200,300,348,898,148,598,2,true,true,true,-1.0
2,2,0.5,0.5,true,true,200,250,199,249,-1,-1,1,true,true,true,-1.0
2,2,0.5,0.5,true,true,250,850,798,898,548,48,2,true,true,true,-1.0
2,2,0.5,0.5,true,true,850,200,899,799,49,599,1,true,true,true,-1.0
2,2,0.5,0.5,true,true,250,200,248,198,-2,-2,2,true,true,true,-1.0
2,2,0.5,0.5,true,true,300,200,300,200,0,0,0,true,true,true,-1.0
2,2,0.5,0.5,true,true,250,850,249,849,-1,-1,1,true,true,true,-1.0
2,2,0.5,0.5,true,true,200,200,200,200,0,0,0,true,true,true,-1.0
2,2,0.5,0.5,true,true,850,300,849,299,-1,-1,1,true,true,true,-1.0
2,2,0.5,0.5,true,true,350,250,399,799,49,549,1,true,true,true,-1.0
2,2,0.5,0.5,true,true,350,250,349,249,-1,-1,1,true,true,true,-1.0
2,2,0.5,0.5,true,true,850,300,849,299,-1,-1,1,true,true,true,-1.0
2,2,0.5,0.5,true,true,200,350,199,349,-1,-1,1,true,true,true,-1.0
2,2,0.5,0.5,true,true,350,250,399,299,49,49,1,true,true,true,-1.0
2,2,0.5,0.5,true,false,850,250,849,249,-1,-1,1,true,true,true,488.033
2,2,0.5,0.5,true,false,350,200,349,199,-1,-1,1,true,true,true,-1.0
2,2,0.5,0.5,true,false,850,300,849,299,-1,-1,1,true,true,true,-1.0
2,2,0.5,0.5,true,false,350,250,349,249,-1,-1,1,true,true,true,-1.0
2,2,0.5,0.5,true,false,200,300,198,298,-2,-2,2,true,true,true,-1.0
2,2,0.5,0.5,true,false,300,300,299,299,-1,-1,1,true,true,true,-1.0
2,2,0.5,0.5,true,false,250,300,347,347,97,47,3,true,true,true,-1.0
2,2,0.5,0.5,true,false,850,300,849,299,-1,-1,1,true,true,true,-1.0
2,2,0.5,0.5,true,false,300,300,795,945,495,645,5,true,true,true,-1.0
2,2,0.5,0.5,true,false,900,250,899,249,-1,-1,1,true,true,true,-1.0
2,2,0.5,0.5,true,false,300,350,300,350,0,0,0,true,true,true,-1.0
2,2,0.5,0.5,true,false,300,250,300,250,0,0,0,true,true,true,-1.0
2,2,0.5,0.5,true,false,300,350,848,898,548,548,2,true,true,true,-1.0
2,2,0.5,0.5,true,false,300,900,299,899,-1,-1,1,true,true,true,-1.0
2,2,0.5,0.5,true,false,300,350,299,349,-1,-1,1,true,true,true,-1.0
2,2,0.5,0.5,true,false,300,250,349,299,49,49,1,true,true,true,-1.0
2,2,0.5,0.5,true,false,350,300,349,299,-1,-1,1,true,true,true,-1.0
2,2,0.5,0.5,true,false,250,200,799,249,549,49,1,true,true,true,-1.0
2,2,0.5,0.5,true,false,250,350,250,350,0,0,0,true,true,true,-1.0
2,2,0.5,0.5,true,false,850,300,850,300,0,0,0,true,true,true,-1.0
2,2,0.5,0.5,false,true,200,300,298,848,98,548,2,true,true,true,172.595
2,2,0.5,0.5,false,true,300,200,799,249,499,49,1,true,true,true,-1.0
2,2,0.5,0.5,false,true,300,850,299,849,-1,-1,1,true,true,true,-1.0
2,2,0.5,0.5,false,true,850,250,849,249,-1,-1,1,true,true,true,-1.0
2,2,0.5,0.5,false,true,250,350,249,349,-1,-1,1,true,true,true,-1.0
2,2,0.5,0.5,false,true,300,850,300,850,0,0,0,true,true,true,-1.0
2,2,0.5,0.5,false,true,250,850,250,850,0,0,0,true,true,true,-1.0
2,2,0.5,0.5,false,true,300,300,299,299,-1,-1,1,true,true,true,-1.0
2,2,0.5,0.5,false,true,250,300,897,897,647,597,3,true,true,true,-1.0
2,2,0.5,0.5,false,true,300,300,797,897,497,597,3,true,true,true,-1.0
2,2,0.5,0.5,false,true,250,850,249,849,-1,-1,1,true,true,true,-1.0
2,2,0.5,0.5,false,true,250,250,797,397,547,147,3,true,true,true,-1.0
2,2,0.5,0.5,false,true,300,200,300,200,0,0,0,true,true,true,-1.0
2,2,0.5,0.5,false,true,850,350,849,349,-1,-1,1,true,true,true,-1.0
2,2,0.5,0.5,false,true,250,300,248,298,-2,-2,2,true,true,true,-1.0
2,2,0.5,0.5,false,true,250,200,798,348,548,148,2,true,true,true,-1.0
2,2,0.5,0.5,false,true,300,200,300,200,0,0,0,true,true,true,-1.0
2,2,0.5,0.5,false,true,300,200,798,348,498,148,2,true,true,true,-1.0
2,2,0.5,0.5,false,true,250,300,848,848,598,548,2,true,true,true,-1.0
2,2,0.5,0.5,false,true,350,300,349,299,-1,-1,1,true,true,true,-1.0
2,2,0.5,0.5,false,false,300,300,349,799,49,499,1,true,true,true,118.282
2,2,0.5,0.5,false,false,300,350,798,398,498,48,2,true,true,true,-1.0
2,2,0.5,0.5,false,false,850,200,898,798,48,598,2,true,true,true,-1.0
2,2,0.5,0.5,false,false,250,300,799,899,549,599,1,true,true,true,-1.0
2,2,0.5,0.5,false,false,300,350,298,348,-2,-2,2,true,true,true,-1.0
2,2,0.5,0.5,false,false,300,850,299,849,-1,-1,1,true,true,true,-1.0
2,2,0.5,0.5,false,false,850,350,849,349,-1,-1,1,true,true,true,-1.0
2,2,0.5,0.5,false,false,250,350,249,349,-1,-1,1,true,true,true,-1.0
2,2,0.5,0.5,false,false,300,350,297,347,-3,-3,3,true,true,true,-1.0
2,2,0.5,0.5,false,false,300,850,798,898,498,48,2,true,true,true,-1.0
2,2,0.5,0.5,false,false,300,250,299,249,-1,-1,1,true,true,true,-1.0
2,2,0.5,0.5,false,false,850,300,850,300,0,0,0,true,true,true,-1.0
2,2,0.5,0.5,false,false,250,850,799,899,549,49,1,true,true,true,-1.0
2,2,0.5,0.5,false,false,200,250,200,250,0,0,0,false,false,false,-1.0
2,2,0.5,0.5,false,false,300,200,348,298,48,98,2,true,true,true,-1.0
2,2,0.5,0.5,false,false,300,300,300,300,0,0,0,true,true,true,-1.0
2,2,0.5,0.5,false,false,300,300,300,300,0,0,0,true,true,true,-1.0
2,2,0.5,0.5,false,false,300,850,797,897,497,47,3,true,true,true,-1.0
2,2,0.5,0.5,false,false,200,200,298,298,98,98,2,true,true,true,-1.0
2,2,0.5,0.5,false,false,200,300,798,348,598,48,2,true,true,true,-1.0
0,0,0.5,0.5,false,false,300,900,296,896,-4,-4,4,true,true,true,0.204
0,0,0.5,0.5,false,false,350,300,398,798,48,498,2,true,true,true,-1.0
0,0,0.5,0.5,false,false,300,200,297,197,-3,-3,3,true,true,true,-1.0
0,0,0.5,0.5,false,false,250,300,246,296,-4,-4,4,true,true,true,-1.0
0,0,0.5,0.5,false,false,350,300,348,298,-2,-2,2,true,true,true,-1.0
0,0,0.5,0.5,false,false,200,350,797,947,597,597,3,true,true,true,-1.0
0,0,0.5,0.5,false,false,300,850,297,847,-3,-3,3,true,true,true,-1.0
0,0,0.5,0.5,false,false,300,300,296,296,-4,-4,4,true,true,true,-1.0
0,0,0.5,0.5,false,false,850,900,847,897,-3,-3,3,true,true,true,-1.0
0,0,0.5,0.5,false,false,250,350,247,347,-3,-3,3,true,true,true,-1.0
0,0,0.5,0.5,false,false,300,300,296,296,-4,-4,4,true,true,true,-1.0
0,0,0.5,0.5,false,false,300,850,297,847,-3,-3,3,true,true,true,-1.0
0,0,0.5,0.5,false,false,300,300,297,297,-3,-3,3,true,true,true,-1.0
0,0,0.5,0.5,false,false,350,300,396,796,46,496,4,true,true,true,-1.0
0,0,0.5,0.5,false,false,900,850,898,848,-2,-2,2,true,true,true,-1.0
0,0,0.5,0.5,false,false,300,300,799,899,499,599,1,true,true,true,-1.0
0,0,0.5,0.5,false,false,200,350,197,347,-3,-3,3,true,true,true,-1.0
0,0,0.5,0.5,false,false,300,300,296,296,-4,-4,4,false,false,false,-1.0
0,0,0.5,0.5,false,false,850,300,848,298,-2,-2,2,false,false,false,-1.0
0,0,0.5,0.5,false,false,850,850,848,848,-2,-2,2,true,true,true,-1.0
0,1,0.5,0.5,false,false,250,300,298,898,48,598,2,true,true,true,0.295
0,1,0.5,0.5,false,false,250,300,349,799,99,499,1,true,true,true,-1.0
0,1,0.5,0.5,false,false,900,900,896,896,-4,-4,4,true,true,true,-1.0
0,1,0.5,0.5,false,false,200,250,248,798,48,548,2,true,false,true,-1.0
0,1,0.5,0.5,false,false,250,250,246,246,-4,-4,4,true,true,true,-1.0
0,1,0.5,0.5,false,false,300,250,298,248,-2,-2,2,true,true,true,-1.0
0,1,0.5,0.5,false,false,200,350,197,347,-3,-3,3,true,true,true,-1.0
0,1,0.5,0.5,false,false,350,850,346,846,-4,-4,4,true,true,true,-1.0
0,1,0.5,0.5,false,false,250,300,246,296,-4,-4,4,true,true,true,-1.0
0,1,0.5,0.5,false,false,350,300,346,296,-4,-4,4,true,true,true,-1.0
0,1,0.5,0.5,false,false,250,250,247,247,-3,-3,3,true,true,true,-1.0
0,1,0.5,0.5,false,false,200,200,797,247,597,47,3,true,true,true,-1.0
0,1,0.5,0.5,false,false,850,200,848,198,-2,-2,2,true,true,true,-1.0
0,1,0.5,0.5,false,false,250,250,296,296,46,46,4,true,true,true,-1.0
0,1,0.5,0.5,false,false,250,200,249,199,-1,-1,1,true,true,true,-1.0
0,1,0.5,0.5,false,false,250,850,797,897,547,47,3,true,true,true,-1.0
0,1,0.5,0.5,false,false,200,850,197,847,-3,-3,3,true,true,true,-1.0
0,1,0.5,0.5,false,false,200,200,199,199,-1,-1,1,true,true,true,-1.0
0,1,0.5,0.5,false,false,250,200,348,798,98,598,2,true,true,true,-1.0
0,1,0.5,0.5,false,false,300,250,346,296,46,46,4,true,true,true,-1.0
0,2,0.5,0.5,false,true,850,300,846,296,-4,-4,4,true,true,true,376.108
0,2,0.5,0.5,false,true,250,900,798,948,548,48,2,true,true,true,-1.0
0,2,0.5,0.5,false,true,300,300,296,296,-4,-4,4,true,true,true,-1.0
0,2,0.5,0.5,false,true,300,300,296,296,-4,-4,4,true,true,true,-1.0
0,2,0.5,0.5,false,true,350,250,346,246,-4,-4,4,false,false,false,-1.0
0,2,0.5,0.5,false,true,200,300,298,848,98,548,2,true,true,true,-1.0
0,2,0.5,0.5,false,true,300,300,297,297,-3,-3,3,true,true,true,-1.0
0,2,0.5,0.5,false,true,350,850,346,846,-4,-4,4,true,true,true,-1.0
0,2,0.5,0.5,false,true,300,250,398,798,98,548,2,false,false,true,-1.0
0,2,0.5,0.5,false,true,300,250,799,299,499,49,1,true,true,true,-1.0
0,2,0.5,0.5,false,true,350,300,347,297,-3,-3,3,true,true,true,-1.0
0,2,0.5,0.5,false,true,250,350,799,949,549,599,1,true,true,true,-1.0
0,2,0.5,0.5,false,true,200,850,196,846,-4,-4,4,true,true,true,-1.0
0,2,0.5,0.5,false,true,300,300,347,797,47,497,3,true,true,true,-1.0
0,2,0.5,0.5,false,true,200,300,196,296,-4,-4,4,true,true,true,-1.0
0,2,0.5,0.5,false,true,850,850,849,849,-1,-1,1,true,true,true,-1.0
0,2,0.5,0.5,false,true,250,300,246,296,-4,-4,4,true,true,true,-1.0
0,2,0.5,0.5,false,true,200,850,197,847,-3,-3,3,true,true,true,-1.0
0,2,0.5,0.5,false,true,300,850,297,847,-3,-3,3,true,true,true,-1.0
0,2,0.5,0.5,false,true,200,200,196,196,-4,-4,4,false,false,false,-1.0
0,2,0.5,0.5,false,false,900,850,896,846,-4,-4,4,true,true,true,77.946
0,2,0.5,0.5,false,false,250,850,246,846,-4,-4,4,true,true,true,-1.0
0,2,0.5,0.5,false,false,300,850,296,846,-4,-4,4,true,true,true,-1.0
0,2,0.5,0.5,false,false,200,200,248,248,48,48,2,true,true,true,-1.0
0,2,0.5,0.5,false,false,300,200,299,199,-1,-1,1,true,true,true,-1.0
0,2,0.5,0.5,false,false,250,300,246,296,-4,-4,4,true,true,true,-1.0
0,2,0.5,0.5,false,false,300,850,297,847,-3,-3,3,true,true,true,-1.0
0,2,0.5,0.5,false,false,200,850,199,849,-1,-1,1,true,true,true,-1.0
0,2,0.5,0.5,false,false,250,850,296,896,46,46,4,true,true,true,-1.0
0,2,0.5,0.5,false,false,200,250,799,399,599,149,1,true,true,true,-1.0
0,2,0.5,0.5,false,false,850,300,846,296,-4,-4,4,true,true,true,-1.0
0,2,0.5,0.5,false,false,300,200,797,247,497,47,3,true,true,true,-1.0
0,2,0.5,0.5,false,false,850,350,846,346,-4,-4,4,true,true,true,-1.0
0,2,0.5,0.5,false,false,850,300,848,298,-2,-2,2,true,true,true,-1.0
0,2,0.5,0.5,false,false,300,250,296,246,-4,-4,4,true,true,true,-1.0
0,2,0.5,0.5,false,false,850,300,898,798,48,498,2,true,true,true,-1.0
0,2,0.5,0.5,false,false,200,850,248,898,48,48,2,true,true,true,-1.0
0,2,0.5,0.5,false,false,200,250,199,249,-1,-1,1,true,true,true,-1.0
0,2,0.5,0.5,false,false,300,300,298,298,-2,-2,2,true,true,true,-1.0
0,2,0.5,0.5,false,false,300,300,348,798,48,498,2,true,true,true,-1.0
1,0,0.5,0.5,false,false,200,250,248,798,48,548,2,true,true,true,0.33
1,0,0.5,0.5,false,false,300,300,295,295,-5,-5,5,true,true,true,-1.0
1,0,0.5,0.5,false,false,250,850,799,899,549,49,1,true,true,true,-1.0
1,0,0.5,0.5,false,false,300,300,297,297,-3,-3,3,true,true,true,-1.0
1,0,0.5,0.5,false,false,200,250,298,798,98,548,2,true,true,true,-1.0
1,0,0.5,0.5,false,false,200,200,249,849,49,649,1,true,true,true,-1.0
1,0,0.5,0.5,false,false,250,200,797,347,547,147,3,true,true,true,-1.0
1,0,0.5,0.5,false,false,350,250,897,297,547,47,3,true,true,true,-1.0
1,0,0.5,0.5,false,false,850,200,847,197,-3,-3,3,true,true,true,-1.0
1,0,0.5,0.5,false,false,350,300,345,295,-5,-5,5,true,true,true,-1.0
1,0,0.5,0.5,false,false,300,300,349,799,49,499,1,true,true,true,-1.0
1,0,0.5,0.5,false,false,350,300,347,297,-3,-3,3,true,true,true,-1.0
1,0,0.5,0.5,false,false,300,300,396,796,96,496,4,true,true,true,-1.0
1,0,0.5,0.5,false,false,350,300,345,295,-5,-5,5,true,true,true,-1.0
1,0,0.5,0.5,false,false,200,850,249,899,49,49,1,true,true,true,-1.0
1,0,0.5,0.5,false,false,200,250,200,250,0,0,0,true,true,true,-1.0
1,0,0.5,0.5,false,false,350,200,350,200,0,0,0,true,true,true,-1.0
1,0,0.5,0.5,false,false,250,850,247,847,-3,-3,3,true,true,true,-1.0
1,0,0.5,0.5,false,false,250,200,948,798,698,598,2,true,true,true,-1.0
1,0,0.5,0.5,false,false,250,300,250,300,0,0,0,true,true,true,-1.0
1,1,0.5,0.5,false,false,300,300,349,799,49,499,1,true,true,true,1.597
1,1,0.5,0.5,false,false,850,200,850,200,0,0,0,true,true,true,-1.0
1,1,0.5,0.5,false,false,250,300,298,798,48,498,2,true,true,true,-1.0
1,1,0.5,0.5,false,false,850,300,800,250,-50,-50,50,true,true,true,-1.0
1,1,0.5,0.5,false,false,300,200,898,798,598,598,2,true,true,true,-1.0
1,1,0.5,0.5,false,false,250,850,799,899,549,49,1,true,true,true,-1.0
1,1,0.5,0.5,false,false,850,350,847,347,-3,-3,3,true,true,true,-1.0
1,1,0.5,0.5,false,false,200,350,249,399,49,49,1,true,true,true,-1.0
1,1,0.5,0.5,false,false,300,250,848,898,548,648,2,true,true,true,-1.0
1,1,0.5,0.5,false,false,300,200,349,249,49,49,1,true,true,true,-1.0
1,1,0.5,0.5,false,false,250,200,200,150,-50,-50,50,true,true,true,-1.0
1,1,0.5,0.5,false,false,350,850,300,800,-50,-50,50,true,true,true,-1.0
1,1,0.5,0.5,false,false,300,300,799,349,499,49,1,true,true,true,-1.0
1,1,0.5,0.5,false,false,250,300,247,297,-3,-3,3,true,true,true,-1.0
1,1,0.5,0.5,false,false,900,300,850,250,-50,-50,50,true,true,true,-1.0
1,1,0.5,0.5,false,false,300,200,300,200,0,0,0,true,true,true,-1.0
1,1,0.5,0.5,false,false,250,250,247,247,-3,-3,3,true,true,true,-1.0
1,1,0.5,0.5,false,false,200,250,248,298,48,48,2,true,true,true,-1.0
1,1,0.5,0.5,false,false,850,300,898,798,48,498,2,true,true,true,-1.0
1,1,0.5,0.5,false,false,250,200,849,899,599,699,1,true,true,true,-1.0
1,2,0.5,0.5,false,true,250,300,298,898,48,598,2,true,true,true,340.36
1,2,0.5,0.5,false,true,850,300,896,796,46,496,4,true,true,true,-1.0
1,2,0.5,0.5,false,true,850,300,848,298,-2,-2,2,true,true,true,-1.0
1,2,0.5,0.5,false,true,200,250,248,798,48,548,2,true,true,true,-1.0
1,2,0.5,0.5,false,true,900,250,943,293,43,43,7,true,true,true,-1.0
1,2,0.5,0.5,false,true,300,350,300,350,0,0,0,true,true,true,-1.0
1,2,0.5,0.5,false,true,300,300,799,899,499,599,1,true,true,true,-1.0
1,2,0.5,0.5,false,true,250,300,349,799,99,499,1,true,true,true,-1.0
1,2,0.5,0.5,false,true,300,850,298,848,-2,-2,2,true,true,true,-1.0
1,2,0.5,0.5,false,true,900,850,898,848,-2,-2,2,true,true,true,-1.0
1,2,0.5,0.5,false,true,200,200,198,198,-2,-2,2,true,true,true,-1.0
1,2,0.5,0.5,false,true,250,200,797,247,547,47,3,true,true,true,-1.0
1,2,0.5,0.5,false,true,200,300,198,298,-2,-2,2,true,true,true,-1.0
1,2,0.5,0.5,false,true,850,200,850,200,0,0,0,true,true,true,-1.0
1,2,0.5,0.5,false,true,900,250,898,248,-2,-2,2,true,true,true,-1.0
1,2,0.5,0.5,false,true,850,350,850,350,0,0,0,true,true,true,-1.0
1,2,0.5,0.5,false,true,850,300,848,298,-2,-2,2,true,true,true,-1.0
1,2,0.5,0.5,false,true,300,850,298,848,-2,-2,2,true,true,true,-1.0
1,2,0.5,0.5,false,true,250,200,200,150,-50,-50,50,false,false,false,-1.0
1,2,0.5,0.5,false,true,300,300,797,347,497,47,3,true,true,true,-1.0
1,2,0.5,0.5,false,false,250,300,949,799,699,499,1,true,true,true,120.324
1,2,0.5,0.5,false,false,300,900,298,898,-2,-2,2,true,true,true,-1.0
1,2,0.5,0.5,false,false,300,250,296,246,-4,-4,4,true,true,true,-1.0
1,2,0.5,0.5,false,false,300,300,347,347,47,47,3,true,true,true,-1.0
1,2,0.5,0.5,false,false,300,350,348,898,48,548,2,true,true,true,-1.0
1,2,0.5,0.5,false,false,300,250,797,397,497,147,3,true,true,true,-1.0
1,2,0.5,0.5,false,false,350,350,347,347,-3,-3,3,true,true,true,-1.0
1,2,0.5,0.5,false,false,300,300,347,897,47,597,3,true,true,true,-1.0
1,2,0.5,0.5,false,false,250,250,799,349,549,99,1,true,true,true,-1.0
1,2,0.5,0.5,false,false,850,850,848,848,-2,-2,2,true,true,true,-1.0
1,2,0.5,0.5,false,false,200,850,200,850,0,0,0,true,true,true,-1.0
1,2,0.5,0.5,false,false,300,350,300,350,0,0,0,true,true,true,-1.0
1,2,0.5,0.5,false,false,900,850,898,848,-2,-2,2,true,true,true,-1.0
1,2,0.5,0.5,false,false,250,200,298,298,48,98,2,true,true,true,-1.0
1,2,0.5,0.5,false,false,350,350,350,350,0,0,0,true,true,true,-1.0
1,2,0.5,0.5,false,false,850,200,850,200,0,0,0,false,false,false,-1.0
1,2,0.5,0.5,false,false,850,850,848,848,-2,-2,2,true,true,true,-1.0
1,2,0.5,0.5,false,false,250,200,797,347,547,147,3,true,true,true,-1.0
1,2,0.5,0.5,false,false,250,200,797,247,547,47,3,true,true,true,-1.0
1,2,0.5,0.5,false,false,350,300,350,300,0,0,0,true,true,true,-1.0
2,0,0.5,0.5,true,false,200,200,200,200,0,0,0,true,true,true,725.232
2,0,0.5,0.5,true,false,350,250,350,250,0,0,0,true,true,true,-1.0
2,0,0.5,0.5,true,false,200,350,299,949,99,599,1,true,true,true,-1.0
2,0,0.5,0.5,true,false,250,850,247,847,-3,-3,3,false,false,false,-1.0
2,0,0.5,0.5,true,false,300,850,297,847,-3,-3,3,true,true,true,-1.0
2,0,0.5,0.5,true,false,850,250,899,299,49,49,1,true,true,true,-1.0
2,0,0.5,0.5,true,false,300,300,349,799,49,499,1,true,true,true,-1.0
2,0,0.5,0.5,true,false,200,200,196,196,-4,-4,4,true,true,true,-1.0
2,0,0.5,0.5,true,false,350,300,899,849,549,549,1,true,true,true,-1.0
2,0,0.5,0.5,true,false,200,350,197,347,-3,-3,3,true,true,true,-1.0
2,0,0.5,0.5,true,false,200,300,246,796,46,496,4,true,true,true,-1.0
2,0,0.5,0.5,true,false,200,250,297,297,97,47,3,true,true,true,-1.0
2,0,0.5,0.5,true,false,350,200,347,197,-3,-3,3,true,true,true,-1.0
2,0,0.5,0.5,true,false,350,850,350,850,0,0,0,true,true,true,-1.0
2,0,0.5,0.5,true,false,250,300,897,797,647,497,3,true,true,true,-1.0
2,0,0.5,0.5,true,false,850,300,846,296,-4,-4,4,true,true,true,-1.0
2,0,0.5,0.5,true,false,300,300,349,799,49,499,1,true,true,true,-1.0
2,0,0.5,0.5,true,false,350,250,347,247,-3,-3,3,true,true,true,-1.0
2,0,0.5,0.5,true,false,850,850,847,847,-3,-3,3,true,true,true,-1.0
2,0,0.5,0.5,true,false,900,250,900,250,0,0,0,true,true,true,-1.0
2,0,0.5,0.5,false,false,850,300,850,300,0,0,0,true,true,true,104.602
2,0,0.5,0.5,false,false,350,200,350,200,0,0,0,true,true,true,-1.0
2,0,0.5,0.5,false,false,850,300,847,297,-3,-3,3,true,true,true,-1.0
2,0,0.5,0.5,false,false,200,200,200,200,0,0,0,true,true,true,-1.0
2,0,0.5,0.5,false,false,300,350,295,345,-5,-5,5,true,true,true,-1.0
2,0,0.5,0.5,false,false,850,300,899,799,49,499,1,true,true,true,-1.0
2,0,0.5,0.5,false,false,900,300,949,799,49,499,1,true,true,true,-1.0
2,0,0.5,0.5,false,false,350,250,947,297,597,47,3,true,true,true,-1.0
2,0,0.5,0.5,false,false,250,300,298,798,48,498,2,true,true,true,-1.0
2,0,0.5,0.5,false,false,200,200,195,195,-5,-5,5,true,true,true,-1.0
2,0,0.5,0.5,false,false,300,350,297,347,-3,-3,3,true,true,true,-1.0
2,0,0.5,0.5,false,false,300,850,297,847,-3,-3,3,true,true,true,-1.0
2,0,0.5,0.5,false,false,300,300,296,296,-4,-4,4,true,true,true,-1.0
2,0,0.5,0.5,false,false,200,300,299,799,99,499,1,true,true,true,-1.0
2,0,0.5,0.5,false,false,250,300,247,297,-3,-3,3,true,true,true,-1.0
2,0,0.5,0.5,false,false,250,850,247,847,-3,-3,3,true,true,true,-1.0
2,0,0.5,0.5,false,false,300,200,898,798,598,598,2,true,true,true,-1.0
2,0,0.5,0.5,false,false,300,300,297,297,-3,-3,3,true,true,true,-1.0
2,0,0.5,0.5,false,false,200,250,197,247,-3,-3,3,true,true,true,-1.0
2,0,0.5,0.5,false,false,200,250,195,245,-5,-5,5,true,true,true,-1.0
2,1,0.5,0.5,true,false,850,350,847,347,-3,-3,3,true,true,true,1035.72
2,1,0.5,0.5,true,false,350,850,347,847,-3,-3,3,true,true,true,-1.0
2,1,0.5,0.5,true,false,250,300,798,398,548,98,2,true,true,true,-1.0
2,1,0.5,0.5,true,false,300,300,300,300,0,0,0,true,true,true,-1.0
2,1,0.5,0.5,true,false,300,300,297,297,-3,-3,3,true,true,true,-1.0
2,1,0.5,0.5,true,false,850,250,899,299,49,49,1,true,true,true,-1.0
2,1,0.5,0.5,true,false,200,300,200,300,0,0,0,true,true,true,-1.0
2,1,0.5,0.5,true,false,850,300,899,799,49,499,1,true,true,true,-1.0
2,1,0.5,0.5,true,false,850,200,850,200,0,0,0,true,true,true,-1.0
2,1,0.5,0.5,true,false,850,250,848,248,-2,-2,2,true,true,true,-1.0
2,1,0.5,0.5,true,false,850,300,898,798,48,498,2,true,true,true,-1.0
2,1,0.5,0.5,true,false,850,200,850,200,0,0,0,true,true,true,-1.0
2,1,0.5,0.5,true,false,350,200,899,349,549,149,1,true,true,true,-1.0
2,1,0.5,0.5,true,false,300,300,799,349,499,49,1,true,true,true,-1.0
2,1,0.5,0.5,true,false,250,200,797,247,547,47,3,true,true,true,-1.0
2,1,0.5,0.5,true,false,250,250,797,897,547,647,3,true,true,true,-1.0
2,1,0.5,0.5,true,false,250,850,250,850,0,0,0,true,true,true,-1.0
2,1,0.5,0.5,true,false,250,250,299,799,49,549,1,true,true,true,-1.0
2,1,0.5,0.5,true,false,200,900,199,899,-1,-1,1,true,true,true,-1.0
2,1,0.5,0.5,true,false,300,250,297,247,-3,-3,3,true,true,true,-1.0
2,1,0.5,0.5,false,false,250,850,247,847,-3,-3,3,true,true,true,139.282
2,1,0.5,0.5,false,false,300,250,297,247,-3,-3,3,true,true,true,-1.0
2,1,0.5,0.5,false,false,250,300,247,297,-3,-3,3,true,true,true,-1.0
2,1,0.5,0.5,false,false,300,200,349,249,49,49,1,true,true,true,-1.0
2,1,0.5,0.5,false,false,850,250,850,250,0,0,0,true,true,true,-1.0
2,1,0.5,0.5,false,false,250,200,247,197,-3,-3,3,true,true,true,-1.0
2,1,0.5,0.5,false,false,200,300,150,250,-50,-50,50,false,false,false,-1.0
2,1,0.5,0.5,false,false,250,350,247,347,-3,-3,3,true,true,true,-1.0
2,1,0.5,0.5,false,false,850,250,847,247,-3,-3,3,true,true,true,-1.0
2,1,0.5,0.5,false,false,300,250,798,348,498,98,2,true,true,true,-1.0
2,1,0.5,0.5,false,false,350,350,347,347,-3,-3,3,true,true,true,-1.0
2,1,0.5,0.5,false,false,850,250,850,250,0,0,0,true,true,true,-1.0
2,1,0.5,0.5,false,false,300,850,299,849,-1,-1,1,true,true,true,-1.0
2,1,0.5,0.5,false,false,200,250,197,247,-3,-3,3,true,true,true,-1.0
2,1,0.5,0.5,false,false,250,300,799,349,549,49,1,true,true,true,-1.0
2,1,0.5,0.5,false,false,300,350,848,898,548,548,2,true,true,true,-1.0
2,1,0.5,0.5,false,false,250,300,899,349,649,49,1,true,true,true,-1.0
2,1,0.5,0.5,false,false,200,200,200,200,0,0,0,true,true,true,-1.0
2,1,0.5,0.5,false,false,300,350,297,347,-3,-3,3,true,true,true,-1.0
2,1,0.5,0.5,false,false,200,300,197,297,-3,-3,3,true,true,true,-1.0
2,2,0.5,0.5,true,true,250,850,798,898,548,48,2,true,true,true,525.229
2,2,0.5,0.5,true,true,300,200,299,199,-1,-1,1,true,true,true,-1.0
2,2,0.5,0.5,true,true,200,250,799,349,599,99,1,true,true,true,-1.0
2,2,0.5,0.5,true,true,850,300,849,299,-1,-1,1,true,true,true,-1.0
2,2,0.5,0.5,true,true,200,900,798,948,598,48,2,true,true,true,-1.0
2,2,0.5,0.5,true,true,300,250,298,248,-2,-2,2,true,true,true,-1.0
2,2,0.5,0.5,true,true,200,300,200,300,0,0,0,true,true,true,-1.0
2,2,0.5,0.5,true,true,250,250,797,797,547,547,3,true,true,true,-1.0
2,2,0.5,0.5,true,true,200,250,199,249,-1,-1,1,true,true,true,-1.0
2,2,0.5,0.5,true,true,300,350,299,349,-1,-1,1,true,true,true,-1.0
2,2,0.5,0.5,true,true,250,300,249,299,-1,-1,1,true,true,true,-1.0
2,2,0.5,0.5,true,true,300,250,799,899,499,649,1,true,true,true,-1.0
2,2,0.5,0.5,true,true,350,250,348,248,-2,-2,2,true,true,true,-1.0
2,2,0.5,0.5,true,true,850,200,847,197,-3,-3,3,true,true,true,-1.0
2,2,0.5,0.5,true,true,350,250,898,298,548,48,2,true,true,true,-1.0
2,2,0.5,0.5,true,true,200,200,249,249,49,49,1,true,false,true,-1.0
2,2,0.5,0.5,true,true,300,350,799,949,499,599,1,true,true,true,-1.0
2,2,0.5,0.5,true,true,200,200,200,200,0,0,0,true,true,true,-1.0
2,2,0.5,0.5,true,true,300,200,799,249,499,49,1,true,true,true,-1.0
2,2,0.5,0.5,true,true,300,250,298,248,-2,-2,2,true,true,true,-1.0
2,2,0.5,0.5,true,false,300,250,300,250,0,0,0,true,true,true,407.9
2,2,0.5,0.5,true,false,350,250,349,249,-1,-1,1,true,true,true,-1.0
2,2,0.5,0.5,true,false,250,850,249,849,-1,-1,1,true,true,true,-1.0
2,2,0.5,0.5,true,false,350,850,349,849,-1,-1,1,true,true,true,-1.0
2,2,0.5,0.5,true,false,300,200,799,249,499,49,1,true,true,true,-1.0
2,2,0.5,0.5,true,false,250,350,897,897,647,547,3,true,true,true,-1.0
2,2,0.5,0.5,true,false,300,300,300,300,0,0,0,true,true,true,-1.0
2,2,0.5,0.5,true,false,250,300,296,896,46,596,4,true,true,true,-1.0
2,2,0.5,0.5,true,false,300,300,799,949,499,649,1,true,true,true,-1.0
2,2,0.5,0.5,true,false,200,200,199,199,-1,-1,1,true,true,true,-1.0
2,2,0.5,0.5,true,false,200,300,897,347,697,47,3,true,true,true,-1.0
2,2,0.5,0.5,true,false,250,300,250,300,0,0,0,true,true,true,-1.0
2,2,0.5,0.5,true,false,250,300,248,298,-2,-2,2,true,true,true,-1.0
2,2,0.5,0.5,true,false,200,250,798,898,598,648,2,true,true,true,-1.0
2,2,0.5,0.5,true,false,250,300,249,299,-1,-1,1,true,true,true,-1.0
2,2,0.5,0.5,true,false,250,300,296,346,46,46,4,true,true,true,-1.0
2,2,0.5,0.5,true,false,850,200,899,249,49,49,1,true,true,true,-1.0
2,2,0.5,0.5,true,false,300,200,798,798,498,598,2,true,true,true,-1.0
2,2,0.5,0.5,true,false,300,250,799,299,499,49,1,true,true,true,-1.0
2,2,0.5,0.5,true,false,300,300,799,399,499,99,1,true,true,true,-1.0
2,2,0.5,0.5,false,true,350,300,350,300,0,0,0,true,true,true,172.107
2,2,0.5,0.5,false,true,350,900,348,898,-2,-2,2,true,true,true,-1.0
2,2,0.5,0.5,false,true,250,900,250,900,0,0,0,true,true,true,-1.0
2,2,0.5,0.5,false,true,300,900,299,899,-1,-1,1,true,true,true,-1.0
2,2,0.5,0.5,false,true,300,300,348,798,48,498,2,true,true,true,-1.0
2,2,0.5,0.5,false,true,200,200,198,198,-2,-2,2,true,true,true,-1.0
2,2,0.5,0.5,false,true,200,300,298,898,98,598,2,true,true,true,-1.0
2,2,0.5,0.5,false,true,200,350,198,348,-2,-2,2,true,true,true,-1.0
2,2,0.5,0.5,false,true,200,250,198,248,-2,-2,2,true,true,true,-1.0
2,2,0.5,0.5,false,true,900,250,900,250,0,0,0,true,true,true,-1.0
2,2,0.5,0.5,false,true,300,300,298,298,-2,-2,2,true,true,true,-1.0
2,2,0.5,0.5,false,true,250,200,299,299,49,99,1,true,true,true,-1.0
2,2,0.5,0.5,false,true,250,350,249,349,-1,-1,1,true,true,true,-1.0
2,2,0.5,0.5,false,true,300,250,300,250,0,0,0,true,true,true,-1.0
2,2,0.5,0.5,false,true,850,300,850,300,0,0,0,true,true,true,-1.0
2,2,0.5,0.5,false,true,300,300,798,398,498,98,2,true,true,true,-1.0
2,2,0.5,0.5,false,true,300,250,299,249,-1,-1,1,true,true,true,-1.0
2,2,0.5,0.5,false,true,300,300,797,347,497,47,3,true,true,true,-1.0
2,2,0.5,0.5,false,true,300,300,348,798,48,498,2,true,true,true,-1.0
2,2,0.5,0.5,false,true,300,200,898,248,598,48,2,true,true,true,-1.0
2,2,0.5,0.5,false,false,350,850,349,849,-1,-1,1,true,true,true,142.603
2,2,0.5,0.5,false,false,250,300,299,799,49,499,1,true,false,true,-1.0
2,2,0.5,0.5,false,false,250,250,348,798,98,548,2,true,true,true,-1.0
2,2,0.5,0.5,false,false,300,250,799,299,499,49,1,true,true,true,-1.0
2,2,0.5,0.5,false,false,250,200,250,200,0,0,0,true,true,true,-1.0
2,2,0.5,0.5,false,false,200,300,298,848,98,548,2,true,true,true,-1.0
2,2,0.5,0.5,false,false,200,900,198,898,-2,-2,2,true,true,true,-1.0
2,2,0.5,0.5,false,false,200,300,198,298,-2,-2,2,true,true,true,-1.0
2,2,0.5,0.5,false,false,200,250,199,249,-1,-1,1,true,true,true,-1.0
2,2,0.5,0.5,false,false,250,300,248,298,-2,-2,2,true,true,true,-1.0
2,2,0.5,0.5,false,false,200,300,296,846,96,546,4,true,true,true,-1.0
2,2,0.5,0.5,false,false,300,200,797,397,497,197,3,true,true,true,-1.0
2,2,0.5,0.5,false,false,350,250,897,297,547,47,3,true,true,true,-1.0
2,2,0.5,0.5,false,false,900,300,949,799,49,499,1,true,true,true,-1.0
2,2,0.5,0.5,false,false,250,200,787,387,537,187,13,true,true,true,-1.0
2,2,0.5,0.5,false,false,850,250,850,250,0,0,0,true,true,true,-1.0
2,2,0.5,0.5,false,false,300,350,299,349,-1,-1,1,true,true,true,-1.0
2,2,0.5,0.5,false,false,300,850,298,848,-2,-2,2,true,true,true,-1.0
2,2,0.5,0.5,false,false,300,300,897,897,597,597,3,true,true,true,-1.0
2,2,0.5,0.5,false,false,200,200,200,200,0,0,0,true,true,true,-1.0
