init_tom,resp_tom,init_lr,resp_lr,init_canLie,resp_canLie,init_initPoints,resp_respPoints,init_finalPoints,resp_finalPoints,init_gain,resp_gain,nr_offers,outcome_is_PE,passed_time
0,0,0.5,0.5,false,false,350,300,398,798,48,498,2,true,0.523
0,0,0.5,0.5,false,false,200,850,197,847,-3,-3,3,false,-1.0
0,0,0.5,0.5,false,false,250,300,297,897,47,597,3,true,-1.0
0,0,0.5,0.5,false,false,900,900,897,897,-3,-3,3,true,-1.0
0,0,0.5,0.5,false,false,350,200,897,347,547,147,3,true,-1.0
0,0,0.5,0.5,false,false,250,250,298,798,48,548,2,true,-1.0
0,0,0.5,0.5,false,false,300,250,897,297,597,47,3,true,-1.0
0,0,0.5,0.5,false,false,300,250,348,798,48,548,2,true,-1.0
0,0,0.5,0.5,false,false,300,850,297,847,-3,-3,3,true,-1.0
0,0,0.5,0.5,false,false,250,350,799,399,549,49,1,true,-1.0
0,1,0.5,0.5,false,false,300,300,296,296,-4,-4,4,true,0.477
0,1,0.5,0.5,false,false,850,200,846,196,-4,-4,4,false,-1.0
0,1,0.5,0.5,false,false,850,250,898,798,48,548,2,true,-1.0
0,1,0.5,0.5,false,false,250,250,249,249,-1,-1,1,true,-1.0
0,1,0.5,0.5,false,false,300,250,298,248,-2,-2,2,true,-1.0
0,1,0.5,0.5,false,false,900,850,898,848,-2,-2,2,true,-1.0
0,1,0.5,0.5,false,false,200,300,197,297,-3,-3,3,true,-1.0
0,1,0.5,0.5,false,false,850,300,846,296,-4,-4,4,true,-1.0
0,1,0.5,0.5,false,false,200,850,798,898,598,48,2,true,-1.0
0,1,0.5,0.5,false,false,350,300,346,296,-4,-4,4,true,-1.0
0,2,0.5,0.5,false,true,850,200,846,196,-4,-4,4,false,358.168
0,2,0.5,0.5,false,true,250,350,247,347,-3,-3,3,true,-1.0
0,2,0.5,0.5,false,true,350,350,346,346,-4,-4,4,true,-1.0
0,2,0.5,0.5,false,true,350,300,398,798,48,498,2,true,-1.0
0,2,0.5,0.5,false,true,250,200,348,798,98,598,2,true,-1.0
0,2,0.5,0.5,false,true,250,300,898,798,648,498,2,true,-1.0
0,2,0.5,0.5,false,true,850,850,846,846,-4,-4,4,true,-1.0
0,2,0.5,0.5,false,true,250,250,246,246,-4,-4,4,true,-1.0
0,2,0.5,0.5,false,true,350,300,897,847,547,547,3,true,-1.0
0,2,0.5,0.5,false,true,850,200,846,196,-4,-4,4,true,-1.0
0,2,0.5,0.5,false,false,300,200,799,349,499,149,1,true,58.084
0,2,0.5,0.5,false,false,300,200,797,247,497,47,3,true,-1.0
0,2,0.5,0.5,false,false,300,250,797,297,497,47,3,true,-1.0
0,2,0.5,0.5,false,false,300,300,296,296,-4,-4,4,true,-1.0
0,2,0.5,0.5,false,false,250,850,246,846,-4,-4,4,true,-1.0
0,2,0.5,0.5,false,false,300,300,348,798,48,498,2,true,-1.0
0,2,0.5,0.5,false,false,300,250,348,798,48,548,2,true,-1.0
0,2,0.5,0.5,false,false,850,250,896,796,46,546,4,true,-1.0
0,2,0.5,0.5,false,false,200,350,298,898,98,548,2,true,-1.0
0,2,0.5,0.5,false,false,850,850,849,849,-1,-1,1,true,-1.0
1,0,0.5,0.5,false,false,250,250,247,247,-3,-3,3,true,0.288
1,0,0.5,0.5,false,false,850,850,847,847,-3,-3,3,true,-1.0
1,0,0.5,0.5,false,false,200,300,797,397,597,97,3,true,-1.0
1,0,0.5,0.5,false,false,250,250,247,247,-3,-3,3,true,-1.0
1,0,0.5,0.5,false,false,250,850,799,899,549,49,1,true,-1.0
1,0,0.5,0.5,false,false,350,300,949,799,599,499,1,true,-1.0
1,0,0.5,0.5,false,false,200,250,249,299,49,49,1,true,-1.0
1,0,0.5,0.5,false,false,250,850,247,847,-3,-3,3,true,-1.0
1,0,0.5,0.5,false,false,300,200,797,247,497,47,3,false,-1.0
1,0,0.5,0.5,false,false,850,200,845,195,-5,-5,5,true,-1.0
1,1,0.5,0.5,false,false,200,300,200,300,0,0,0,true,1.192
1,1,0.5,0.5,false,false,300,350,300,350,0,0,0,true,-1.0
1,1,0.5,0.5,false,false,200,350,799,949,599,599,1,true,-1.0
1,1,0.5,0.5,false,false,200,850,197,847,-3,-3,3,true,-1.0
1,1,0.5,0.5,false,false,350,200,350,200,0,0,0,true,-1.0
1,1,0.5,0.5,false,false,300,300,250,250,-50,-50,50,true,-1.0
1,1,0.5,0.5,false,false,200,200,197,197,-3,-3,3,true,-1.0
1,1,0.5,0.5,false,false,250,250,200,200,-50,-50,50,true,-1.0
1,1,0.5,0.5,false,false,850,300,898,798,48,498,2,true,-1.0
1,1,0.5,0.5,false,false,250,250,200,200,-50,-50,50,false,-1.0
1,2,0.5,0.5,false,true,250,200,298,248,48,48,2,true,355.501
1,2,0.5,0.5,false,true,250,850,248,848,-2,-2,2,true,-1.0
1,2,0.5,0.5,false,true,300,300,799,899,499,599,1,true,-1.0
1,2,0.5,0.5,false,true,250,350,250,350,0,0,0,true,-1.0
1,2,0.5,0.5,false,true,350,250,899,849,549,599,1,true,-1.0
1,2,0.5,0.5,false,true,200,250,249,299,49,49,1,true,-1.0
1,2,0.5,0.5,false,true,300,250,298,248,-2,-2,2,true,-1.0
1,2,0.5,0.5,false,true,250,200,799,399,549,199,1,true,-1.0
1,2,0.5,0.5,false,true,250,300,299,799,49,499,1,true,-1.0
1,2,0.5,0.5,false,true,200,350,248,898,48,548,2,true,-1.0
1,2,0.5,0.5,false,false,300,250,799,299,499,49,1,true,175.437
1,2,0.5,0.5,false,false,300,850,797,897,497,47,3,true,-1.0
1,2,0.5,0.5,false,false,200,250,248,798,48,548,2,true,-1.0
1,2,0.5,0.5,false,false,300,300,345,795,45,495,5,true,-1.0
1,2,0.5,0.5,false,false,200,200,200,200,0,0,0,true,-1.0
1,2,0.5,0.5,false,false,300,250,300,250,0,0,0,true,-1.0
1,2,0.5,0.5,false,false,250,250,248,248,-2,-2,2,true,-1.0
1,2,0.5,0.5,false,false,300,250,799,799,499,549,1,true,-1.0
1,2,0.5,0.5,false,false,300,900,298,898,-2,-2,2,true,-1.0
1,2,0.5,0.5,false,false,850,250,850,250,0,0,0,true,-1.0
2,0,0.5,0.5,true,false,300,300,797,347,497,47,3,true,504.622
2,0,0.5,0.5,true,false,300,850,297,847,-3,-3,3,true,-1.0
2,0,0.5,0.5,true,false,300,250,797,297,497,47,3,true,-1.0
2,0,0.5,0.5,true,false,850,850,847,847,-3,-3,3,true,-1.0
2,0,0.5,0.5,true,false,250,200,799,249,549,49,1,true,-1.0
2,0,0.5,0.5,true,false,850,850,847,847,-3,-3,3,true,-1.0
2,0,0.5,0.5,true,false,300,350,797,397,497,47,3,true,-1.0
2,0,0.5,0.5,true,false,300,300,297,297,-3,-3,3,false,-1.0
2,0,0.5,0.5,true,false,300,200,297,197,-3,-3,3,true,-1.0
2,0,0.5,0.5,true,false,350,850,350,850,0,0,0,true,-1.0
2,0,0.5,0.5,false,false,200,200,200,200,0,0,0,true,80.806
2,0,0.5,0.5,false,false,200,350,200,350,0,0,0,true,-1.0
2,0,0.5,0.5,false,false,250,300,247,297,-3,-3,3,true,-1.0
2,0,0.5,0.5,false,false,300,200,897,247,597,47,3,true,-1.0
2,0,0.5,0.5,false,false,300,300,797,347,497,47,3,true,-1.0
2,0,0.5,0.5,false,false,850,300,847,297,-3,-3,3,true,-1.0
2,0,0.5,0.5,false,false,250,300,797,347,547,47,3,false,-1.0
2,0,0.5,0.5,false,false,250,300,299,799,49,499,1,true,-1.0
2,0,0.5,0.5,false,false,200,300,197,297,-3,-3,3,true,-1.0
2,0,0.5,0.5,false,false,250,250,247,247,-3,-3,3,false,-1.0
2,1,0.5,0.5,true,false,200,200,200,200,0,0,0,true,569.96
2,1,0.5,0.5,true,false,200,250,200,250,0,0,0,true,-1.0
2,1,0.5,0.5,true,false,900,300,949,799,49,499,1,true,-1.0
2,1,0.5,0.5,true,false,250,300,299,799,49,499,1,true,-1.0
2,1,0.5,0.5,true,false,300,850,299,849,-1,-1,1,true,-1.0
2,1,0.5,0.5,true,false,850,850,850,850,0,0,0,true,-1.0
2,1,0.5,0.5,true,false,350,200,350,200,0,0,0,true,-1.0
2,1,0.5,0.5,true,false,250,250,799,299,549,49,1,true,-1.0
2,1,0.5,0.5,true,false,300,300,250,250,-50,-50,50,false,-1.0
2,1,0.5,0.5,true,false,250,200,247,197,-3,-3,3,true,-1.0
2,1,0.5,0.5,false,false,250,350,798,948,548,598,2,true,155.792
2,1,0.5,0.5,false,false,300,300,297,297,-3,-3,3,true,-1.0
2,1,0.5,0.5,false,false,850,250,847,247,-3,-3,3,true,-1.0
2,1,0.5,0.5,false,false,200,300,197,297,-3,-3,3,true,-1.0
2,1,0.5,0.5,false,false,350,200,399,249,49,49,1,true,-1.0
2,1,0.5,0.5,false,false,200,300,197,297,-3,-3,3,true,-1.0
2,1,0.5,0.5,false,false,200,250,248,298,48,48,2,true,-1.0
2,1,0.5,0.5,false,false,350,300,948,798,598,498,2,true,-1.0
2,1,0.5,0.5,false,false,300,300,297,297,-3,-3,3,true,-1.0
2,1,0.5,0.5,false,false,250,350,247,347,-3,-3,3,true,-1.0
2,2,0.5,0.5,true,true,200,300,298,798,98,498,2,true,489.802
2,2,0.5,0.5,true,true,250,350,249,349,-1,-1,1,true,-1.0
2,2,0.5,0.5,true,true,200,300,198,298,-2,-2,2,true,-1.0
2,2,0.5,0.5,true,true,850,300,850,300,0,0,0,true,-1.0
2,2,0.5,0.5,true,true,300,850,298,848,-2,-2,2,true,-1.0
2,2,0.5,0.5,true,true,300,300,299,299,-1,-1,1,true,-1.0
2,2,0.5,0.5,true,true,200,300,298,848,98,548,2,true,-1.0
2,2,0.5,0.5,true,true,200,250,248,298,48,48,2,true,-1.0
2,2,0.5,0.5,true,true,300,300,797,897,497,597,3,true,-1.0
2,2,0.5,0.5,true,true,300,250,299,249,-1,-1,1,true,-1.0
2,2,0.5,0.5,true,false,300,200,299,199,-1,-1,1,true,328.172
2,2,0.5,0.5,true,false,300,850,299,849,-1,-1,1,true,-1.0
2,2,0.5,0.5,true,false,300,350,297,347,-3,-3,3,true,-1.0
2,2,0.5,0.5,true,false,300,200,798,248,498,48,2,false,-1.0
2,2,0.5,0.5,true,false,250,900,248,898,-2,-2,2,true,-1.0
2,2,0.5,0.5,true,false,250,250,299,299,49,49,1,true,-1.0
2,2,0.5,0.5,true,false,200,850,298,898,98,48,2,true,-1.0
2,2,0.5,0.5,true,false,850,250,898,798,48,548,2,true,-1.0
2,2,0.5,0.5,true,false,850,200,850,200,0,0,0,true,-1.0
2,2,0.5,0.5,true,false,850,850,849,849,-1,-1,1,true,-1.0
2,2,0.5,0.5,false,true,200,300,248,898,48,598,2,true,142.318
2,2,0.5,0.5,false,true,200,250,200,250,0,0,0,true,-1.0
2,2,0.5,0.5,false,true,250,900,248,898,-2,-2,2,true,-1.0
2,2,0.5,0.5,false,true,250,850,248,848,-2,-2,2,true,-1.0
2,2,0.5,0.5,false,true,300,300,298,298,-2,-2,2,true,-1.0
2,2,0.5,0.5,false,true,300,250,899,799,599,549,1,true,-1.0
2,2,0.5,0.5,false,true,250,300,249,299,-1,-1,1,true,-1.0
2,2,0.5,0.5,false,true,250,300,298,948,48,648,2,true,-1.0
2,2,0.5,0.5,false,true,250,300,348,798,98,498,2,true,-1.0
2,2,0.5,0.5,false,true,850,850,849,849,-1,-1,1,true,-1.0
2,2,0.5,0.5,false,false,300,850,299,849,-1,-1,1,true,93.435
2,2,0.5,0.5,false,false,250,850,249,849,-1,-1,1,true,-1.0
2,2,0.5,0.5,false,false,200,300,399,799,199,499,1,true,-1.0
2,2,0.5,0.5,false,false,300,250,300,250,0,0,0,true,-1.0
2,2,0.5,0.5,false,false,250,250,797,297,547,47,3,true,-1.0
2,2,0.5,0.5,false,false,300,250,798,348,498,98,2,true,-1.0
2,2,0.5,0.5,false,false,250,250,789,339,539,89,11,true,-1.0
2,2,0.5,0.5,false,false,250,250,244,244,-6,-6,6,true,-1.0
2,2,0.5,0.5,false,false,300,200,346,296,46,96,4,false,-1.0
2,2,0.5,0.5,false,false,300,200,300,200,0,0,0,true,-1.0
0,0,0.5,0.5,false,false,350,250,397,297,47,47,3,true,0.168
0,0,0.5,0.5,false,false,250,250,799,299,549,49,1,false,-1.0
0,0,0.5,0.5,false,false,850,300,848,298,-2,-2,2,true,-1.0
0,0,0.5,0.5,false,false,850,200,847,197,-3,-3,3,true,-1.0
0,0,0.5,0.5,false,false,850,250,848,248,-2,-2,2,true,-1.0
0,0,0.5,0.5,false,false,350,250,348,248,-2,-2,2,true,-1.0
0,0,0.5,0.5,false,false,200,300,196,296,-4,-4,4,true,-1.0
0,0,0.5,0.5,false,false,850,250,847,247,-3,-3,3,true,-1.0
0,0,0.5,0.5,false,false,200,200,297,247,97,47,3,true,-1.0
0,0,0.5,0.5,false,false,850,250,846,246,-4,-4,4,true,-1.0
0,1,0.5,0.5,false,false,250,300,348,798,98,498,2,true,0.22
0,1,0.5,0.5,false,false,200,250,799,949,599,699,1,true,-1.0
0,1,0.5,0.5,false,false,250,300,246,296,-4,-4,4,true,-1.0
0,1,0.5,0.5,false,false,300,250,797,297,497,47,3,true,-1.0
0,1,0.5,0.5,false,false,300,300,299,299,-1,-1,1,true,-1.0
0,1,0.5,0.5,false,false,300,200,797,347,497,147,3,true,-1.0
0,1,0.5,0.5,false,false,200,900,248,948,48,48,2,true,-1.0
0,1,0.5,0.5,false,false,300,850,299,849,-1,-1,1,true,-1.0
0,1,0.5,0.5,false,false,250,300,298,798,48,498,2,true,-1.0
0,1,0.5,0.5,false,false,250,300,298,798,48,498,2,true,-1.0
0,2,0.5,0.5,false,true,250,200,799,299,549,99,1,true,285.245
0,2,0.5,0.5,false,true,300,300,297,297,-3,-3,3,true,-1.0
0,2,0.5,0.5,false,true,300,250,296,246,-4,-4,4,false,-1.0
0,2,0.5,0.5,false,true,300,850,296,846,-4,-4,4,true,-1.0
0,2,0.5,0.5,false,true,850,300,846,296,-4,-4,4,true,-1.0
0,2,0.5,0.5,false,true,850,850,846,846,-4,-4,4,true,-1.0
0,2,0.5,0.5,false,true,300,250,296,246,-4,-4,4,true,-1.0
0,2,0.5,0.5,false,true,850,300,846,296,-4,-4,4,true,-1.0
0,2,0.5,0.5,false,true,200,850,196,846,-4,-4,4,true,-1.0
0,2,0.5,0.5,false,true,900,350,896,346,-4,-4,4,true,-1.0
0,2,0.5,0.5,false,false,850,300,898,798,48,498,2,true,53.814
0,2,0.5,0.5,false,false,300,350,296,346,-4,-4,4,false,-1.0
0,2,0.5,0.5,false,false,200,250,348,798,148,548,2,true,-1.0
0,2,0.5,0.5,false,false,250,250,348,798,98,548,2,true,-1.0
0,2,0.5,0.5,false,false,200,250,199,249,-1,-1,1,true,-1.0
0,2,0.5,0.5,false,false,900,300,896,296,-4,-4,4,true,-1.0
0,2,0.5,0.5,false,false,300,300,298,298,-2,-2,2,true,-1.0
0,2,0.5,0.5,false,false,300,300,296,296,-4,-4,4,true,-1.0
0,2,0.5,0.5,false,false,250,200,799,899,549,699,1,true,-1.0
0,2,0.5,0.5,false,false,250,350,298,898,48,548,2,true,-1.0
1,0,0.5,0.5,false,false,250,350,247,347,-3,-3,3,true,0.278
1,0,0.5,0.5,false,false,200,300,298,798,98,498,2,true,-1.0
1,0,0.5,0.5,false,false,350,200,350,200,0,0,0,true,-1.0
1,0,0.5,0.5,false,false,250,300,245,295,-5,-5,5,false,-1.0
1,0,0.5,0.5,false,false,200,850,195,845,-5,-5,5,false,-1.0
1,0,0.5,0.5,false,false,350,850,347,847,-3,-3,3,true,-1.0
1,0,0.5,0.5,false,false,850,850,847,847,-3,-3,3,true,-1.0
1,0,0.5,0.5,false,false,250,350,247,347,-3,-3,3,true,-1.0
1,0,0.5,0.5,false,false,300,300,297,297,-3,-3,3,true,-1.0
1,0,0.5,0.5,false,false,250,250,298,848,48,598,2,true,-1.0
1,1,0.5,0.5,false,false,250,250,297,297,47,47,3,true,0.915
1,1,0.5,0.5,false,false,850,300,800,250,-50,-50,50,true,-1.0
1,1,0.5,0.5,false,false,200,250,200,250,0,0,0,true,-1.0
1,1,0.5,0.5,false,false,250,250,799,299,549,49,1,true,-1.0
1,1,0.5,0.5,false,false,300,200,348,798,48,598,2,true,-1.0
1,1,0.5,0.5,false,false,850,200,847,197,-3,-3,3,true,-1.0
1,1,0.5,0.5,false,false,300,900,798,948,498,48,2,true,-1.0
1,1,0.5,0.5,false,false,200,900,195,895,-5,-5,5,true,-1.0
1,1,0.5,0.5,false,false,300,250,250,200,-50,-50,50,false,-1.0
1,1,0.5,0.5,false,false,850,300,850,300,0,0,0,true,-1.0
1,2,0.5,0.5,false,true,350,300,350,300,0,0,0,true,678.072
1,2,0.5,0.5,false,true,300,200,799,249,499,49,1,true,-1.0
1,2,0.5,0.5,false,true,300,250,798,298,498,48,2,true,-1.0
1,2,0.5,0.5,false,true,300,300,348,798,48,498,2,false,-1.0
1,2,0.5,0.5,false,true,250,300,299,799,49,499,1,true,-1.0
1,2,0.5,0.5,false,true,850,300,850,300,0,0,0,true,-1.0
1,2,0.5,0.5,false,true,250,200,250,200,0,0,0,false,-1.0
1,2,0.5,0.5,false,true,300,250,797,297,497,47,3,true,-1.0
1,2,0.5,0.5,false,true,250,250,298,798,48,548,2,true,-1.0
1,2,0.5,0.5,false,true,300,300,848,898,548,598,2,true,-1.0
1,2,0.5,0.5,false,false,850,300,850,300,0,0,0,true,73.812
1,2,0.5,0.5,false,false,250,300,296,896,46,596,4,true,-1.0
1,2,0.5,0.5,false,false,850,300,850,300,0,0,0,true,-1.0
1,2,0.5,0.5,false,false,900,300,898,298,-2,-2,2,true,-1.0
1,2,0.5,0.5,false,false,250,250,200,200,-50,-50,50,false,-1.0
1,2,0.5,0.5,false,false,200,850,198,848,-2,-2,2,true,-1.0
1,2,0.5,0.5,false,false,250,350,799,399,549,49,1,true,-1.0
1,2,0.5,0.5,false,false,350,250,398,798,48,548,2,true,-1.0
1,2,0.5,0.5,false,false,300,250,849,849,549,599,1,true,-1.0
1,2,0.5,0.5,false,false,850,250,899,299,49,49,1,true,-1.0
2,0,0.5,0.5,true,false,850,200,850,200,0,0,0,true,516.907
2,0,0.5,0.5,true,false,300,900,297,897,-3,-3,3,true,-1.0
2,0,0.5,0.5,true,false,300,250,298,248,-2,-2,2,true,-1.0
2,0,0.5,0.5,true,false,350,200,347,197,-3,-3,3,true,-1.0
2,0,0.5,0.5,true,false,250,250,299,799,49,549,1,true,-1.0
2,0,0.5,0.5,true,false,200,300,200,300,0,0,0,true,-1.0
2,0,0.5,0.5,true,false,250,350,245,345,-5,-5,5,true,-1.0
2,0,0.5,0.5,true,false,200,200,200,200,0,0,0,true,-1.0
2,0,0.5,0.5,true,false,850,350,846,346,-4,-4,4,true,-1.0
2,0,0.5,0.5,true,false,350,300,949,799,599,499,1,true,-1.0
2,0,0.5,0.5,false,false,200,850,249,899,49,49,1,true,84.261
2,0,0.5,0.5,false,false,300,300,295,295,-5,-5,5,true,-1.0
2,0,0.5,0.5,false,false,900,200,900,200,0,0,0,true,-1.0
2,0,0.5,0.5,false,false,300,300,398,798,98,498,2,true,-1.0
2,0,0.5,0.5,false,false,300,200,300,200,0,0,0,true,-1.0
2,0,0.5,0.5,false,false,300,200,898,798,598,598,2,true,-1.0
2,0,0.5,0.5,false,false,900,300,900,300,0,0,0,true,-1.0
2,0,0.5,0.5,false,false,250,250,797,297,547,47,3,true,-1.0
2,0,0.5,0.5,false,false,200,250,898,798,698,548,2,true,-1.0
2,0,0.5,0.5,false,false,200,250,797,297,597,47,3,true,-1.0
2,1,0.5,0.5,true,false,300,300,797,397,497,97,3,true,690.087
2,1,0.5,0.5,true,false,300,300,798,348,498,48,2,true,-1.0
2,1,0.5,0.5,true,false,300,300,297,297,-3,-3,3,true,-1.0
2,1,0.5,0.5,true,false,200,250,246,296,46,46,4,true,-1.0
2,1,0.5,0.5,true,false,850,250,847,247,-3,-3,3,true,-1.0
2,1,0.5,0.5,true,false,350,300,347,297,-3,-3,3,true,-1.0
2,1,0.5,0.5,true,false,850,300,850,300,0,0,0,true,-1.0
2,1,0.5,0.5,true,false,300,350,297,347,-3,-3,3,true,-1.0
2,1,0.5,0.5,true,false,300,250,297,247,-3,-3,3,true,-1.0
2,1,0.5,0.5,true,false,300,900,297,897,-3,-3,3,true,-1.0
2,1,0.5,0.5,false,false,200,300,197,297,-3,-3,3,true,140.153
2,1,0.5,0.5,false,false,250,200,299,249,49,49,1,true,-1.0
2,1,0.5,0.5,false,false,250,300,848,898,598,598,2,true,-1.0
2,1,0.5,0.5,false,false,200,300,248,798,48,498,2,true,-1.0
2,1,0.5,0.5,false,false,200,200,200,200,0,0,0,true,-1.0
2,1,0.5,0.5,false,false,200,850,197,847,-3,-3,3,true,-1.0
2,1,0.5,0.5,false,false,200,850,299,899,99,49,1,true,-1.0
2,1,0.5,0.5,false,false,250,300,250,300,0,0,0,true,-1.0
2,1,0.5,0.5,false,false,300,250,300,250,0,0,0,true,-1.0
2,1,0.5,0.5,false,false,200,850,197,847,-3,-3,3,true,-1.0
2,2,0.5,0.5,true,true,300,200,299,199,-1,-1,1,true,363.931
2,2,0.5,0.5,true,true,250,850,248,848,-2,-2,2,true,-1.0
2,2,0.5,0.5,true,true,350,250,899,299,549,49,1,false,-1.0
2,2,0.5,0.5,true,true,850,850,849,849,-1,-1,1,true,-1.0
2,2,0.5,0.5,true,true,350,250,899,299,549,49,1,true,-1.0
2,2,0.5,0.5,true,true,250,250,248,248,-2,-2,2,true,-1.0
2,2,0.5,0.5,true,true,900,200,949,249,49,49,1,true,-1.0
2,2,0.5,0.5,true,true,250,250,798,298,548,48,2,true,-1.0
2,2,0.5,0.5,true,true,250,250,249,249,-1,-1,1,true,-1.0
2,2,0.5,0.5,true,true,850,900,849,899,-1,-1,1,true,-1.0
2,2,0.5,0.5,true,false,300,250,898,848,598,598,2,true,572.011
2,2,0.5,0.5,true,false,300,300,299,299,-1,-1,1,true,-1.0
2,2,0.5,0.5,true,false,250,350,249,349,-1,-1,1,true,-1.0
2,2,0.5,0.5,true,false,300,300,299,299,-1,-1,1,true,-1.0
2,2,0.5,0.5,true,false,250,300,297,347,47,47,3,true,-1.0
2,2,0.5,0.5,true,false,300,350,798,398,498,48,2,true,-1.0
2,2,0.5,0.5,true,false,300,300,294,294,-6,-6,6,true,-1.0
2,2,0.5,0.5,true,false,850,250,898,798,48,548,2,true,-1.0
2,2,0.5,0.5,true,false,250,850,200,800,-50,-50,50,true,-1.0
2,2,0.5,0.5,true,false,300,300,398,798,98,498,2,true,-1.0
2,2,0.5,0.5,false,true,250,300,247,297,-3,-3,3,true,130.267
2,2,0.5,0.5,false,true,300,200,798,248,498,48,2,true,-1.0
2,2,0.5,0.5,false,true,250,300,298,798,48,498,2,false,-1.0
2,2,0.5,0.5,false,true,300,300,798,348,498,48,2,true,-1.0
2,2,0.5,0.5,false,true,350,250,350,250,0,0,0,true,-1.0
2,2,0.5,0.5,false,true,250,300,299,799,49,499,1,true,-1.0
2,2,0.5,0.5,false,true,300,200,799,249,499,49,1,true,-1.0
2,2,0.5,0.5,false,true,200,300,199,299,-1,-1,1,true,-1.0
2,2,0.5,0.5,false,true,200,300,248,798,48,498,2,true,-1.0
2,2,0.5,0.5,false,true,850,850,849,849,-1,-1,1,true,-1.0
2,2,0.5,0.5,false,false,200,200,798,348,598,148,2,true,71.747
2,2,0.5,0.5,false,false,300,250,349,799,49,549,1,true,-1.0
2,2,0.5,0.5,false,false,250,200,298,298,48,98,2,true,-1.0
2,2,0.5,0.5,false,false,850,250,849,249,-1,-1,1,true,-1.0
2,2,0.5,0.5,false,false,300,300,796,946,496,646,4,true,-1.0
2,2,0.5,0.5,false,false,200,850,198,848,-2,-2,2,true,-1.0
2,2,0.5,0.5,false,false,350,300,349,299,-1,-1,1,true,-1.0
2,2,0.5,0.5,false,false,250,250,249,249,-1,-1,1,true,-1.0
2,2,0.5,0.5,false,false,300,850,299,849,-1,-1,1,true,-1.0
2,2,0.5,0.5,false,false,200,300,293,393,93,93,7,true,-1.0
0,0,0.5,0.5,false,false,850,300,846,296,-4,-4,4,true,0.184
0,0,0.5,0.5,false,false,300,350,797,397,497,47,3,true,-1.0
0,0,0.5,0.5,false,false,350,200,899,349,549,149,1,true,-1.0
0,0,0.5,0.5,false,false,250,300,246,296,-4,-4,4,true,-1.0
0,0,0.5,0.5,false,false,850,850,848,848,-2,-2,2,true,-1.0
0,0,0.5,0.5,false,false,850,250,847,247,-3,-3,3,true,-1.0
0,0,0.5,0.5,false,false,850,200,848,198,-2,-2,2,true,-1.0
0,0,0.5,0.5,false,false,250,250,798,348,548,98,2,true,-1.0
0,0,0.5,0.5,false,false,350,200,346,196,-4,-4,4,true,-1.0
0,0,0.5,0.5,false,false,200,250,197,247,-3,-3,3,true,-1.0
0,1,0.5,0.5,false,false,250,250,296,296,46,46,4,true,0.258
0,1,0.5,0.5,false,false,250,200,246,196,-4,-4,4,true,-1.0
0,1,0.5,0.5,false,false,300,300,348,798,48,498,2,true,-1.0
0,1,0.5,0.5,false,false,300,250,296,246,-4,-4,4,false,-1.0
0,1,0.5,0.5,false,false,850,250,846,246,-4,-4,4,true,-1.0
0,1,0.5,0.5,false,false,300,200,296,196,-4,-4,4,true,-1.0
0,1,0.5,0.5,false,false,300,300,799,899,499,599,1,true,-1.0
0,1,0.5,0.5,false,false,350,250,349,249,-1,-1,1,true,-1.0
0,1,0.5,0.5,false,false,200,200,248,898,48,698,2,true,-1.0
0,1,0.5,0.5,false,false,300,200,296,196,-4,-4,4,false,-1.0
0,2,0.5,0.5,false,true,900,350,896,346,-4,-4,4,true,310.41
0,2,0.5,0.5,false,true,200,300,248,848,48,548,2,true,-1.0
0,2,0.5,0.5,false,true,350,300,346,296,-4,-4,4,true,-1.0
0,2,0.5,0.5,false,true,200,200,199,199,-1,-1,1,true,-1.0
0,2,0.5,0.5,false,true,200,200,196,196,-4,-4,4,true,-1.0
0,2,0.5,0.5,false,true,250,300,246,296,-4,-4,4,true,-1.0
0,2,0.5,0.5,false,true,350,900,346,896,-4,-4,4,true,-1.0
0,2,0.5,0.5,false,true,250,200,249,199,-1,-1,1,true,-1.0
0,2,0.5,0.5,false,true,200,200,199,199,-1,-1,1,true,-1.0
0,2,0.5,0.5,false,true,250,250,246,246,-4,-4,4,true,-1.0
0,2,0.5,0.5,false,false,200,300,199,299,-1,-1,1,true,55.075
0,2,0.5,0.5,false,false,850,300,846,296,-4,-4,4,true,-1.0
0,2,0.5,0.5,false,false,850,300,846,296,-4,-4,4,true,-1.0
0,2,0.5,0.5,false,false,850,350,848,348,-2,-2,2,true,-1.0
0,2,0.5,0.5,false,false,350,250,398,798,48,548,2,true,-1.0
0,2,0.5,0.5,false,false,850,200,846,196,-4,-4,4,true,-1.0
0,2,0.5,0.5,false,false,900,200,898,198,-2,-2,2,true,-1.0
0,2,0.5,0.5,false,false,200,250,199,249,-1,-1,1,true,-1.0
0,2,0.5,0.5,false,false,200,250,248,798,48,548,2,true,-1.0
0,2,0.5,0.5,false,false,200,850,199,849,-1,-1,1,true,-1.0
1,0,0.5,0.5,false,false,300,300,946,796,646,496,4,true,0.274
1,0,0.5,0.5,false,false,250,850,797,897,547,47,3,true,-1.0
1,0,0.5,0.5,false,false,250,250,897,297,647,47,3,true,-1.0
1,0,0.5,0.5,false,false,300,200,797,247,497,47,3,true,-1.0
1,0,0.5,0.5,false,false,200,900,197,897,-3,-3,3,true,-1.0
1,0,0.5,0.5,false,false,850,350,845,345,-5,-5,5,true,-1.0
1,0,0.5,0.5,false,false,200,850,197,847,-3,-3,3,true,-1.0
1,0,0.5,0.5,false,false,200,350,197,347,-3,-3,3,true,-1.0
1,0,0.5,0.5,false,false,300,300,796,346,496,46,4,true,-1.0
1,0,0.5,0.5,false,false,250,350,799,399,549,49,1,true,-1.0
1,1,0.5,0.5,false,false,350,850,350,850,0,0,0,true,1.127
1,1,0.5,0.5,false,false,250,300,250,300,0,0,0,true,-1.0
1,1,0.5,0.5,false,false,300,350,297,347,-3,-3,3,true,-1.0
1,1,0.5,0.5,false,false,300,300,799,899,499,599,1,true,-1.0
1,1,0.5,0.5,false,false,850,250,850,250,0,0,0,true,-1.0
1,1,0.5,0.5,false,false,250,350,200,300,-50,-50,50,false,-1.0
1,1,0.5,0.5,false,false,200,850,298,898,98,48,2,true,-1.0
1,1,0.5,0.5,false,false,850,850,800,800,-50,-50,50,true,-1.0
1,1,0.5,0.5,false,false,250,850,247,847,-3,-3,3,true,-1.0
1,1,0.5,0.5,false,false,300,300,250,250,-50,-50,50,true,-1.0
1,2,0.5,0.5,false,true,200,850,799,899,599,49,1,true,760.938
1,2,0.5,0.5,false,true,300,850,298,848,-2,-2,2,true,-1.0
1,2,0.5,0.5,false,true,250,300,248,298,-2,-2,2,true,-1.0
1,2,0.5,0.5,false,true,850,250,850,250,0,0,0,true,-1.0
1,2,0.5,0.5,false,true,300,850,297,847,-3,-3,3,true,-1.0
1,2,0.5,0.5,false,true,200,300,249,799,49,499,1,true,-1.0
1,2,0.5,0.5,false,true,250,300,347,797,97,497,3,true,-1.0
1,2,0.5,0.5,false,true,300,200,849,299,549,99,1,true,-1.0
1,2,0.5,0.5,false,true,850,200,848,198,-2,-2,2,true,-1.0
1,2,0.5,0.5,false,true,200,200,200,200,0,0,0,true,-1.0
1,2,0.5,0.5,false,false,850,850,848,848,-2,-2,2,true,60.975
1,2,0.5,0.5,false,false,250,200,248,198,-2,-2,2,true,-1.0
1,2,0.5,0.5,false,false,200,200,150,150,-50,-50,50,false,-1.0
1,2,0.5,0.5,false,false,300,250,799,349,499,99,1,true,-1.0
1,2,0.5,0.5,false,false,850,900,848,898,-2,-2,2,true,-1.0
1,2,0.5,0.5,false,false,300,250,300,250,0,0,0,true,-1.0
1,2,0.5,0.5,false,false,300,850,298,848,-2,-2,2,true,-1.0
1,2,0.5,0.5,false,false,300,300,799,899,499,599,1,true,-1.0
1,2,0.5,0.5,false,false,900,300,900,300,0,0,0,true,-1.0
1,2,0.5,0.5,false,false,300,300,299,299,-1,-1,1,true,-1.0
2,0,0.5,0.5,true,false,250,200,797,397,547,197,3,true,557.523
2,0,0.5,0.5,true,false,250,300,245,295,-5,-5,5,true,-1.0
2,0,0.5,0.5,true,false,200,850,197,847,-3,-3,3,true,-1.0
2,0,0.5,0.5,true,false,200,200,298,798,98,598,2,true,-1.0
2,0,0.5,0.5,true,false,250,300,247,297,-3,-3,3,false,-1.0
2,0,0.5,0.5,true,false,300,200,797,347,497,147,3,true,-1.0
2,0,0.5,0.5,true,false,300,300,295,295,-5,-5,5,false,-1.0
2,0,0.5,0.5,true,false,250,300,898,798,648,498,2,true,-1.0
2,0,0.5,0.5,true,false,200,250,847,297,647,47,3,true,-1.0
2,0,0.5,0.5,true,false,300,250,297,247,-3,-3,3,true,-1.0
2,0,0.5,0.5,false,false,300,200,349,799,49,599,1,true,77.168
2,0,0.5,0.5,false,false,300,300,295,295,-5,-5,5,false,-1.0
2,0,0.5,0.5,false,false,250,200,295,245,45,45,5,true,-1.0
2,0,0.5,0.5,false,false,250,350,296,896,46,546,4,true,-1.0
2,0,0.5,0.5,false,false,350,200,348,198,-2,-2,2,true,-1.0
2,0,0.5,0.5,false,false,200,200,197,197,-3,-3,3,true,-1.0
2,0,0.5,0.5,false,false,300,300,349,799,49,499,1,true,-1.0
2,0,0.5,0.5,false,false,300,850,797,897,497,47,3,true,-1.0
2,0,0.5,0.5,false,false,250,250,298,798,48,548,2,true,-1.0
2,0,0.5,0.5,false,false,250,300,247,297,-3,-3,3,true,-1.0
2,1,0.5,0.5,true,false,250,850,247,847,-3,-3,3,true,1222.415
2,1,0.5,0.5,true,false,300,300,297,297,-3,-3,3,true,-1.0
2,1,0.5,0.5,true,false,300,250,899,349,599,99,1,true,-1.0
2,1,0.5,0.5,true,false,300,300,798,348,498,48,2,true,-1.0
2,1,0.5,0.5,true,false,300,300,297,297,-3,-3,3,true,-1.0
2,1,0.5,0.5,true,false,200,350,298,898,98,548,2,true,-1.0
2,1,0.5,0.5,true,false,850,300,847,297,-3,-3,3,true,-1.0
2,1,0.5,0.5,true,false,300,350,300,350,0,0,0,true,-1.0
2,1,0.5,0.5,true,false,200,250,249,799,49,549,1,true,-1.0
2,1,0.5,0.5,true,false,850,200,899,249,49,49,1,true,-1.0
2,1,0.5,0.5,false,false,200,850,199,849,-1,-1,1,true,88.279
2,1,0.5,0.5,false,false,250,850,799,899,549,49,1,true,-1.0
2,1,0.5,0.5,false,false,850,300,847,297,-3,-3,3,true,-1.0
2,1,0.5,0.5,false,false,300,300,297,297,-3,-3,3,true,-1.0
2,1,0.5,0.5,false,false,250,850,247,847,-3,-3,3,true,-1.0
2,1,0.5,0.5,false,false,900,350,900,350,0,0,0,true,-1.0
2,1,0.5,0.5,false,false,250,300,247,297,-3,-3,3,true,-1.0
2,1,0.5,0.5,false,false,350,250,898,298,548,48,2,true,-1.0
2,1,0.5,0.5,false,false,350,200,897,247,547,47,3,true,-1.0
2,1,0.5,0.5,false,false,850,200,898,798,48,598,2,true,-1.0
2,2,0.5,0.5,true,true,300,300,897,847,597,547,3,true,420.185
2,2,0.5,0.5,true,true,250,250,797,347,547,97,3,true,-1.0
2,2,0.5,0.5,true,true,250,250,250,250,0,0,0,true,-1.0
2,2,0.5,0.5,true,true,250,300,250,300,0,0,0,true,-1.0
2,2,0.5,0.5,true,true,300,300,299,299,-1,-1,1,true,-1.0
2,2,0.5,0.5,true,true,200,900,247,947,47,47,3,true,-1.0
2,2,0.5,0.5,true,true,300,850,299,849,-1,-1,1,true,-1.0
2,2,0.5,0.5,true,true,200,250,249,799,49,549,1,true,-1.0
2,2,0.5,0.5,true,true,250,200,299,799,49,599,1,true,-1.0
2,2,0.5,0.5,true,true,300,200,799,249,499,49,1,true,-1.0
2,2,0.5,0.5,true,false,250,200,249,199,-1,-1,1,true,332.482
2,2,0.5,0.5,true,false,250,250,250,250,0,0,0,true,-1.0
2,2,0.5,0.5,true,false,300,350,300,350,0,0,0,true,-1.0
2,2,0.5,0.5,true,false,250,850,799,899,549,49,1,true,-1.0
2,2,0.5,0.5,true,false,200,300,198,298,-2,-2,2,true,-1.0
2,2,0.5,0.5,true,false,300,900,300,900,0,0,0,true,-1.0
2,2,0.5,0.5,true,false,200,200,849,249,649,49,1,true,-1.0
2,2,0.5,0.5,true,false,900,250,899,249,-1,-1,1,true,-1.0
2,2,0.5,0.5,true,false,250,300,896,796,646,496,4,true,-1.0
2,2,0.5,0.5,true,false,850,300,850,300,0,0,0,true,-1.0
2,2,0.5,0.5,false,true,250,200,247,197,-3,-3,3,true,125.772
2,2,0.5,0.5,false,true,200,300,249,799,49,499,1,true,-1.0
2,2,0.5,0.5,false,true,300,200,898,898,598,698,2,true,-1.0
2,2,0.5,0.5,false,true,300,850,798,898,498,48,2,true,-1.0
2,2,0.5,0.5,false,true,900,300,900,300,0,0,0,true,-1.0
2,2,0.5,0.5,false,true,850,850,849,849,-1,-1,1,true,-1.0
2,2,0.5,0.5,false,true,850,850,850,850,0,0,0,true,-1.0
2,2,0.5,0.5,false,true,250,350,848,898,598,548,2,true,-1.0
2,2,0.5,0.5,false,true,200,300,200,300,0,0,0,true,-1.0
2,2,0.5,0.5,false,true,300,300,299,299,-1,-1,1,true,-1.0
2,2,0.5,0.5,false,false,300,250,891,341,591,91,9,true,79.621
2,2,0.5,0.5,false,false,300,300,348,798,48,498,2,true,-1.0
2,2,0.5,0.5,false,false,300,200,349,249,49,49,1,true,-1.0
2,2,0.5,0.5,false,false,300,300,398,798,98,498,2,true,-1.0
2,2,0.5,0.5,false,false,850,200,898,298,48,98,2,true,-1.0
2,2,0.5,0.5,false,false,250,300,298,798,48,498,2,true,-1.0
2,2,0.5,0.5,false,false,300,250,798,898,498,648,2,true,-1.0
2,2,0.5,0.5,false,false,200,850,199,849,-1,-1,1,true,-1.0
2,2,0.5,0.5,false,false,300,350,299,349,-1,-1,1,true,-1.0
2,2,0.5,0.5,false,false,300,350,299,349,-1,-1,1,true,-1.0
0,0,0.5,0.5,false,false,350,200,397,797,47,597,3,true,0.189
0,0,0.5,0.5,false,false,250,850,246,846,-4,-4,4,true,-1.0
0,0,0.5,0.5,false,false,300,250,298,248,-2,-2,2,true,-1.0
0,0,0.5,0.5,false,false,850,300,846,296,-4,-4,4,true,-1.0
0,0,0.5,0.5,false,false,200,250,246,796,46,546,4,true,-1.0
0,0,0.5,0.5,false,false,900,250,897,247,-3,-3,3,true,-1.0
0,0,0.5,0.5,false,false,300,300,797,347,497,47,3,false,-1.0
0,0,0.5,0.5,false,false,350,250,398,798,48,548,2,true,-1.0
0,0,0.5,0.5,false,false,300,300,797,947,497,647,3,true,-1.0
0,0,0.5,0.5,false,false,200,200,198,198,-2,-2,2,true,-1.0
0,1,0.5,0.5,false,false,350,250,346,246,-4,-4,4,true,0.233
0,1,0.5,0.5,false,false,350,250,346,246,-4,-4,4,true,-1.0
0,1,0.5,0.5,false,false,250,200,348,298,98,98,2,true,-1.0
0,1,0.5,0.5,false,false,200,300,197,297,-3,-3,3,true,-1.0
0,1,0.5,0.5,false,false,850,300,846,296,-4,-4,4,true,-1.0
0,1,0.5,0.5,false,false,900,300,899,299,-1,-1,1,true,-1.0
0,1,0.5,0.5,false,false,300,200,296,196,-4,-4,4,true,-1.0
0,1,0.5,0.5,false,false,300,200,296,196,-4,-4,4,true,-1.0
0,1,0.5,0.5,false,false,350,250,899,849,549,599,1,true,-1.0
0,1,0.5,0.5,false,false,850,300,846,296,-4,-4,4,true,-1.0
0,2,0.5,0.5,false,true,300,300,296,296,-4,-4,4,true,272.843
0,2,0.5,0.5,false,true,900,350,898,348,-2,-2,2,true,-1.0
0,2,0.5,0.5,false,true,200,200,848,898,648,698,2,true,-1.0
0,2,0.5,0.5,false,true,250,300,248,298,-2,-2,2,true,-1.0
0,2,0.5,0.5,false,true,200,250,199,249,-1,-1,1,true,-1.0
0,2,0.5,0.5,false,true,300,250,296,246,-4,-4,4,true,-1.0
0,2,0.5,0.5,false,true,250,300,246,296,-4,-4,4,true,-1.0
0,2,0.5,0.5,false,true,850,850,848,848,-2,-2,2,true,-1.0
0,2,0.5,0.5,false,true,300,850,297,847,-3,-3,3,true,-1.0
0,2,0.5,0.5,false,true,300,250,296,246,-4,-4,4,false,-1.0
0,2,0.5,0.5,false,false,200,350,848,898,648,548,2,true,58.368
0,2,0.5,0.5,false,false,200,300,248,348,48,48,2,true,-1.0
0,2,0.5,0.5,false,false,250,300,247,297,-3,-3,3,true,-1.0
0,2,0.5,0.5,false,false,300,250,346,796,46,546,4,true,-1.0
0,2,0.5,0.5,false,false,850,300,849,299,-1,-1,1,true,-1.0
0,2,0.5,0.5,false,false,300,250,346,796,46,546,4,false,-1.0
0,2,0.5,0.5,false,false,350,300,346,296,-4,-4,4,true,-1.0
0,2,0.5,0.5,false,false,850,250,846,246,-4,-4,4,true,-1.0
0,2,0.5,0.5,false,false,200,300,199,299,-1,-1,1,true,-1.0
0,2,0.5,0.5,false,false,300,900,296,896,-4,-4,4,true,-1.0
1,0,0.5,0.5,false,false,200,250,247,297,47,47,3,true,0.247
1,0,0.5,0.5,false,false,850,250,846,246,-4,-4,4,true,-1.0
1,0,0.5,0.5,false,false,200,250,197,247,-3,-3,3,true,-1.0
1,0,0.5,0.5,false,false,250,300,296,796,46,496,4,true,-1.0
1,0,0.5,0.5,false,false,850,850,847,847,-3,-3,3,true,-1.0
1,0,0.5,0.5,false,false,200,350,197,347,-3,-3,3,true,-1.0
1,0,0.5,0.5,false,false,300,300,797,347,497,47,3,true,-1.0
1,0,0.5,0.5,false,false,300,850,297,847,-3,-3,3,true,-1.0
1,0,0.5,0.5,false,false,300,200,347,247,47,47,3,true,-1.0
1,0,0.5,0.5,false,false,850,200,898,798,48,598,2,true,-1.0
1,1,0.5,0.5,false,false,200,200,248,798,48,598,2,true,0.993
1,1,0.5,0.5,false,false,300,250,798,798,498,548,2,true,-1.0
1,1,0.5,0.5,false,false,900,850,850,800,-50,-50,50,true,-1.0
1,1,0.5,0.5,false,false,300,300,250,250,-50,-50,50,false,-1.0
1,1,0.5,0.5,false,false,300,200,300,200,0,0,0,true,-1.0
1,1,0.5,0.5,false,false,200,850,200,850,0,0,0,true,-1.0
1,1,0.5,0.5,false,false,300,200,300,200,0,0,0,true,-1.0
1,1,0.5,0.5,false,false,250,300,947,797,697,497,3,true,-1.0
1,1,0.5,0.5,false,false,900,250,896,246,-4,-4,4,true,-1.0
1,1,0.5,0.5,false,false,200,300,150,250,-50,-50,50,true,-1.0
1,2,0.5,0.5,false,true,850,250,897,797,47,547,3,true,624.487
1,2,0.5,0.5,false,true,250,350,298,398,48,48,2,true,-1.0
1,2,0.5,0.5,false,true,250,250,797,347,547,97,3,true,-1.0
1,2,0.5,0.5,false,true,300,300,300,300,0,0,0,true,-1.0
1,2,0.5,0.5,false,true,300,200,349,349,49,149,1,true,-1.0
1,2,0.5,0.5,false,true,250,200,250,200,0,0,0,true,-1.0
1,2,0.5,0.5,false,true,350,300,348,298,-2,-2,2,true,-1.0
1,2,0.5,0.5,false,true,850,300,848,298,-2,-2,2,true,-1.0
1,2,0.5,0.5,false,true,300,250,799,299,499,49,1,true,-1.0
1,2,0.5,0.5,false,true,300,250,298,248,-2,-2,2,true,-1.0
1,2,0.5,0.5,false,false,300,250,897,847,597,597,3,true,117.3
1,2,0.5,0.5,false,false,250,350,250,350,0,0,0,true,-1.0
1,2,0.5,0.5,false,false,250,250,298,298,48,48,2,true,-1.0
1,2,0.5,0.5,false,false,200,250,200,250,0,0,0,true,-1.0
1,2,0.5,0.5,false,false,250,200,250,200,0,0,0,true,-1.0
1,2,0.5,0.5,false,false,250,850,248,848,-2,-2,2,true,-1.0
1,2,0.5,0.5,false,false,200,300,198,298,-2,-2,2,true,-1.0
1,2,0.5,0.5,false,false,300,850,298,848,-2,-2,2,true,-1.0
1,2,0.5,0.5,false,false,200,350,246,396,46,46,4,true,-1.0
1,2,0.5,0.5,false,false,850,300,846,296,-4,-4,4,true,-1.0
2,0,0.5,0.5,true,false,300,850,799,899,499,49,1,true,528.172
2,0,0.5,0.5,true,false,300,900,297,897,-3,-3,3,true,-1.0
2,0,0.5,0.5,true,false,350,300,345,295,-5,-5,5,false,-1.0
2,0,0.5,0.5,true,false,300,200,897,247,597,47,3,false,-1.0
2,0,0.5,0.5,true,false,300,250,295,245,-5,-5,5,true,-1.0
2,0,0.5,0.5,true,false,200,200,197,197,-3,-3,3,true,-1.0
2,0,0.5,0.5,true,false,200,850,197,847,-3,-3,3,true,-1.0
2,0,0.5,0.5,true,false,850,300,899,799,49,499,1,true,-1.0
2,0,0.5,0.5,true,false,200,250,847,297,647,47,3,true,-1.0
2,0,0.5,0.5,true,false,300,200,300,200,0,0,0,true,-1.0
2,0,0.5,0.5,false,false,300,350,295,345,-5,-5,5,true,82.906
2,0,0.5,0.5,false,false,200,300,249,849,49,549,1,true,-1.0
2,0,0.5,0.5,false,false,300,200,346,246,46,46,4,true,-1.0
2,0,0.5,0.5,false,false,250,250,348,798,98,548,2,true,-1.0
2,0,0.5,0.5,false,false,250,300,250,300,0,0,0,true,-1.0
2,0,0.5,0.5,false,false,850,200,898,798,48,598,2,true,-1.0
2,0,0.5,0.5,false,false,300,300,295,295,-5,-5,5,true,-1.0
2,0,0.5,0.5,false,false,250,250,245,245,-5,-5,5,true,-1.0
2,0,0.5,0.5,false,false,300,250,295,245,-5,-5,5,true,-1.0
2,0,0.5,0.5,false,false,900,250,948,798,48,548,2,true,-1.0
2,1,0.5,0.5,true,false,250,200,250,200,0,0,0,true,775.372
2,1,0.5,0.5,true,false,300,850,300,850,0,0,0,true,-1.0
2,1,0.5,0.5,true,false,350,250,399,299,49,49,1,true,-1.0
2,1,0.5,0.5,true,false,850,300,847,297,-3,-3,3,true,-1.0
2,1,0.5,0.5,true,false,300,300,297,297,-3,-3,3,true,-1.0
2,1,0.5,0.5,true,false,300,300,348,798,48,498,2,true,-1.0
2,1,0.5,0.5,true,false,300,300,297,297,-3,-3,3,true,-1.0
2,1,0.5,0.5,true,false,250,900,247,897,-3,-3,3,true,-1.0
2,1,0.5,0.5,true,false,250,850,798,898,548,48,2,true,-1.0
2,1,0.5,0.5,true,false,850,300,847,297,-3,-3,3,true,-1.0
2,1,0.5,0.5,false,false,200,200,191,191,-9,-9,9,true,150.486
2,1,0.5,0.5,false,false,300,300,297,297,-3,-3,3,true,-1.0
2,1,0.5,0.5,false,false,300,300,898,798,598,498,2,true,-1.0
2,1,0.5,0.5,false,false,850,250,850,250,0,0,0,true,-1.0
2,1,0.5,0.5,false,false,200,200,249,249,49,49,1,true,-1.0
2,1,0.5,0.5,false,false,850,300,850,300,0,0,0,true,-1.0
2,1,0.5,0.5,false,false,300,250,349,299,49,49,1,true,-1.0
2,1,0.5,0.5,false,false,250,200,398,798,148,598,2,true,-1.0
2,1,0.5,0.5,false,false,300,200,297,197,-3,-3,3,true,-1.0
2,1,0.5,0.5,false,false,250,300,200,250,-50,-50,50,false,-1.0
2,2,0.5,0.5,true,true,300,250,799,299,499,49,1,true,392.721
2,2,0.5,0.5,true,true,350,250,350,250,0,0,0,true,-1.0
2,2,0.5,0.5,true,true,200,200,150,150,-50,-50,50,false,-1.0
2,2,0.5,0.5,true,true,300,350,797,947,497,597,3,true,-1.0
2,2,0.5,0.5,true,true,850,300,850,300,0,0,0,true,-1.0
2,2,0.5,0.5,true,true,300,300,348,798,48,498,2,true,-1.0
2,2,0.5,0.5,true,true,350,850,349,849,-1,-1,1,true,-1.0
2,2,0.5,0.5,true,true,200,250,899,899,699,649,1,true,-1.0
2,2,0.5,0.5,true,true,300,300,299,299,-1,-1,1,true,-1.0
2,2,0.5,0.5,true,true,300,200,300,200,0,0,0,true,-1.0
2,2,0.5,0.5,true,false,250,850,249,849,-1,-1,1,true,344.748
2,2,0.5,0.5,true,false,300,250,798,898,498,648,2,true,-1.0
2,2,0.5,0.5,true,false,200,200,249,249,49,49,1,false,-1.0
2,2,0.5,0.5,true,false,300,300,299,299,-1,-1,1,true,-1.0
2,2,0.5,0.5,true,false,900,300,949,799,49,499,1,true,-1.0
2,2,0.5,0.5,true,false,250,850,797,897,547,47,3,true,-1.0
2,2,0.5,0.5,true,false,200,300,298,848,98,548,2,true,-1.0
2,2,0.5,0.5,true,false,250,250,798,298,548,48,2,true,-1.0
2,2,0.5,0.5,true,false,300,850,299,849,-1,-1,1,true,-1.0
2,2,0.5,0.5,true,false,250,200,249,199,-1,-1,1,true,-1.0
2,2,0.5,0.5,false,true,850,350,850,350,0,0,0,true,109.036
2,2,0.5,0.5,false,true,300,850,299,849,-1,-1,1,true,-1.0
2,2,0.5,0.5,false,true,250,300,299,799,49,499,1,true,-1.0
2,2,0.5,0.5,false,true,250,300,799,349,549,49,1,true,-1.0
2,2,0.5,0.5,false,true,850,300,899,799,49,499,1,true,-1.0
2,2,0.5,0.5,false,true,300,850,798,898,498,48,2,true,-1.0
2,2,0.5,0.5,false,true,250,900,798,948,548,48,2,true,-1.0
2,2,0.5,0.5,false,true,300,300,348,898,48,598,2,true,-1.0
2,2,0.5,0.5,false,true,350,300,899,849,549,549,1,true,-1.0
2,2,0.5,0.5,false,true,850,300,849,299,-1,-1,1,true,-1.0
2,2,0.5,0.5,false,false,200,250,200,250,0,0,0,true,80.146
2,2,0.5,0.5,false,false,350,300,948,798,598,498,2,true,-1.0
2,2,0.5,0.5,false,false,850,200,850,200,0,0,0,true,-1.0
2,2,0.5,0.5,false,false,900,350,899,349,-1,-1,1,true,-1.0
2,2,0.5,0.5,false,false,850,200,850,200,0,0,0,true,-1.0
2,2,0.5,0.5,false,false,200,300,298,848,98,548,2,true,-1.0
2,2,0.5,0.5,false,false,850,250,899,799,49,549,1,true,-1.0
2,2,0.5,0.5,false,false,200,900,248,948,48,48,2,true,-1.0
2,2,0.5,0.5,false,false,300,250,300,250,0,0,0,true,-1.0
2,2,0.5,0.5,false,false,250,200,250,200,0,0,0,true,-1.0
0,0,0.5,0.5,false,false,850,200,898,798,48,598,2,true,0.167
0,0,0.5,0.5,false,false,300,350,296,346,-4,-4,4,true,-1.0
0,0,0.5,0.5,false,false,200,250,247,347,47,97,3,true,-1.0
0,0,0.5,0.5,false,false,850,250,846,246,-4,-4,4,true,-1.0
0,0,0.5,0.5,false,false,250,250,797,347,547,97,3,true,-1.0
0,0,0.5,0.5,false,false,300,200,797,247,497,47,3,true,-1.0
0,0,0.5,0.5,false,false,300,900,297,897,-3,-3,3,true,-1.0
0,0,0.5,0.5,false,false,300,200,797,347,497,147,3,true,-1.0
0,0,0.5,0.5,false,false,250,350,797,947,547,597,3,true,-1.0
0,0,0.5,0.5,false,false,200,850,197,847,-3,-3,3,true,-1.0
0,1,0.5,0.5,false,false,850,200,846,196,-4,-4,4,false,0.226
0,1,0.5,0.5,false,false,300,350,297,347,-3,-3,3,true,-1.0
0,1,0.5,0.5,false,false,250,200,246,196,-4,-4,4,true,-1.0
0,1,0.5,0.5,false,false,300,300,299,299,-1,-1,1,true,-1.0
0,1,0.5,0.5,false,false,250,200,297,247,47,47,3,true,-1.0
0,1,0.5,0.5,false,false,300,300,348,798,48,498,2,true,-1.0
0,1,0.5,0.5,false,false,850,850,849,849,-1,-1,1,true,-1.0
0,1,0.5,0.5,false,false,850,250,898,798,48,548,2,true,-1.0
0,1,0.5,0.5,false,false,200,250,196,246,-4,-4,4,true,-1.0
0,1,0.5,0.5,false,false,200,850,248,898,48,48,2,true,-1.0
0,2,0.5,0.5,false,true,250,250,298,298,48,48,2,true,344.214
0,2,0.5,0.5,false,true,350,250,348,248,-2,-2,2,true,-1.0
0,2,0.5,0.5,false,true,250,850,246,846,-4,-4,4,true,-1.0
0,2,0.5,0.5,false,true,850,200,848,198,-2,-2,2,true,-1.0
0,2,0.5,0.5,false,true,350,300,349,299,-1,-1,1,true,-1.0
0,2,0.5,0.5,false,true,850,250,898,798,48,548,2,true,-1.0
0,2,0.5,0.5,false,true,350,250,899,299,549,49,1,true,-1.0
0,2,0.5,0.5,false,true,850,250,898,798,48,548,2,true,-1.0
0,2,0.5,0.5,false,true,250,300,348,798,98,498,2,true,-1.0
0,2,0.5,0.5,false,true,200,900,248,948,48,48,2,true,-1.0
0,2,0.5,0.5,false,false,250,300,348,898,98,598,2,true,58.607
0,2,0.5,0.5,false,false,900,200,896,196,-4,-4,4,true,-1.0
0,2,0.5,0.5,false,false,200,300,196,296,-4,-4,4,true,-1.0
0,2,0.5,0.5,false,false,200,350,196,346,-4,-4,4,true,-1.0
0,2,0.5,0.5,false,false,300,850,297,847,-3,-3,3,true,-1.0
0,2,0.5,0.5,false,false,300,200,799,899,499,699,1,true,-1.0
0,2,0.5,0.5,false,false,300,300,296,296,-4,-4,4,true,-1.0
0,2,0.5,0.5,false,false,350,200,349,199,-1,-1,1,true,-1.0
0,2,0.5,0.5,false,false,300,200,296,196,-4,-4,4,false,-1.0
0,2,0.5,0.5,false,false,250,850,249,849,-1,-1,1,true,-1.0
1,0,0.5,0.5,false,false,350,250,346,246,-4,-4,4,true,0.314
1,0,0.5,0.5,false,false,850,200,897,247,47,47,3,true,-1.0
1,0,0.5,0.5,false,false,200,850,799,899,599,49,1,true,-1.0
1,0,0.5,0.5,false,false,250,300,797,347,547,47,3,true,-1.0
1,0,0.5,0.5,false,false,350,850,347,847,-3,-3,3,true,-1.0
1,0,0.5,0.5,false,false,250,200,349,799,99,599,1,true,-1.0
1,0,0.5,0.5,false,false,250,350,245,345,-5,-5,5,true,-1.0
1,0,0.5,0.5,false,false,250,250,348,798,98,548,2,true,-1.0
1,0,0.5,0.5,false,false,300,900,297,897,-3,-3,3,true,-1.0
1,0,0.5,0.5,false,false,300,850,297,847,-3,-3,3,true,-1.0
1,1,0.5,0.5,false,false,200,850,197,847,-3,-3,3,true,1.064
1,1,0.5,0.5,false,false,900,200,900,200,0,0,0,true,-1.0
1,1,0.5,0.5,false,false,200,850,200,850,0,0,0,true,-1.0
1,1,0.5,0.5,false,false,200,200,200,200,0,0,0,true,-1.0
1,1,0.5,0.5,false,false,300,300,300,300,0,0,0,true,-1.0
1,1,0.5,0.5,false,false,250,300,200,250,-50,-50,50,true,-1.0
1,1,0.5,0.5,false,false,350,900,300,850,-50,-50,50,true,-1.0
1,1,0.5,0.5,false,false,300,200,300,200,0,0,0,true,-1.0
1,1,0.5,0.5,false,false,850,850,850,850,0,0,0,true,-1.0
1,1,0.5,0.5,false,false,300,200,298,198,-2,-2,2,true,-1.0
1,2,0.5,0.5,false,true,200,300,199,299,-1,-1,1,true,300.21
1,2,0.5,0.5,false,true,250,250,849,299,599,49,1,true,-1.0
1,2,0.5,0.5,false,true,300,300,799,899,499,599,1,true,-1.0
1,2,0.5,0.5,false,true,300,850,298,848,-2,-2,2,true,-1.0
1,2,0.5,0.5,false,true,300,250,298,248,-2,-2,2,true,-1.0
1,2,0.5,0.5,false,true,200,300,397,797,197,497,3,true,-1.0
1,2,0.5,0.5,false,true,200,200,200,200,0,0,0,true,-1.0
1,2,0.5,0.5,false,true,850,200,832,182,-18,-18,18,true,-1.0
1,2,0.5,0.5,false,true,850,300,898,798,48,498,2,true,-1.0
1,2,0.5,0.5,false,true,250,200,299,249,49,49,1,true,-1.0
1,2,0.5,0.5,false,false,200,300,200,300,0,0,0,true,139.83
1,2,0.5,0.5,false,false,850,250,899,799,49,549,1,true,-1.0
1,2,0.5,0.5,false,false,350,300,350,300,0,0,0,true,-1.0
1,2,0.5,0.5,false,false,300,200,300,200,0,0,0,true,-1.0
1,2,0.5,0.5,false,false,250,200,250,200,0,0,0,true,-1.0
1,2,0.5,0.5,false,false,300,200,298,198,-2,-2,2,true,-1.0
1,2,0.5,0.5,false,false,250,250,899,799,649,549,1,true,-1.0
1,2,0.5,0.5,false,false,900,200,850,150,-50,-50,50,false,-1.0
1,2,0.5,0.5,false,false,300,900,300,900,0,0,0,true,-1.0
1,2,0.5,0.5,false,false,300,200,758,308,458,108,42,true,-1.0
2,0,0.5,0.5,true,false,200,200,200,200,0,0,0,true,560.82
2,0,0.5,0.5,true,false,350,200,350,200,0,0,0,true,-1.0
2,0,0.5,0.5,true,false,250,300,298,798,48,498,2,false,-1.0
2,0,0.5,0.5,true,false,300,250,799,349,499,99,1,true,-1.0
2,0,0.5,0.5,true,false,200,300,249,799,49,499,1,true,-1.0
2,0,0.5,0.5,true,false,250,300,247,297,-3,-3,3,true,-1.0
2,0,0.5,0.5,true,false,200,250,200,250,0,0,0,true,-1.0
2,0,0.5,0.5,true,false,300,250,295,245,-5,-5,5,false,-1.0
2,0,0.5,0.5,true,false,300,250,346,796,46,546,4,true,-1.0
2,0,0.5,0.5,true,false,900,250,900,250,0,0,0,true,-1.0
2,0,0.5,0.5,false,false,850,250,850,250,0,0,0,true,82.54
2,0,0.5,0.5,false,false,900,200,900,200,0,0,0,true,-1.0
2,0,0.5,0.5,false,false,300,200,847,247,547,47,3,false,-1.0
2,0,0.5,0.5,false,false,850,250,850,250,0,0,0,true,-1.0
2,0,0.5,0.5,false,false,300,200,300,200,0,0,0,true,-1.0
2,0,0.5,0.5,false,false,250,250,250,250,0,0,0,true,-1.0
2,0,0.5,0.5,false,false,850,250,845,245,-5,-5,5,true,-1.0
2,0,0.5,0.5,false,false,850,850,850,850,0,0,0,true,-1.0
2,0,0.5,0.5,false,false,300,850,297,847,-3,-3,3,true,-1.0
2,0,0.5,0.5,false,false,250,250,247,247,-3,-3,3,true,-1.0
2,1,0.5,0.5,true,false,200,350,191,341,-9,-9,9,true,900.745
2,1,0.5,0.5,true,false,200,300,199,299,-1,-1,1,false,-1.0
2,1,0.5,0.5,true,false,250,300,247,297,-3,-3,3,true,-1.0
2,1,0.5,0.5,true,false,900,200,948,248,48,48,2,true,-1.0
2,1,0.5,0.5,true,false,200,850,197,847,-3,-3,3,true,-1.0
2,1,0.5,0.5,true,false,850,350,847,347,-3,-3,3,true,-1.0
2,1,0.5,0.5,true,false,200,200,799,349,599,149,1,true,-1.0
2,1,0.5,0.5,true,false,300,200,349,249,49,49,1,true,-1.0
2,1,0.5,0.5,true,false,300,300,797,947,497,647,3,true,-1.0
2,1,0.5,0.5,true,false,250,200,849,299,599,99,1,false,-1.0
2,1,0.5,0.5,false,false,200,850,798,898,598,48,2,true,167.033
2,1,0.5,0.5,false,false,200,250,200,250,0,0,0,true,-1.0
2,1,0.5,0.5,false,false,300,300,797,347,497,47,3,true,-1.0
2,1,0.5,0.5,false,false,300,300,799,899,499,599,1,true,-1.0
2,1,0.5,0.5,false,false,300,200,797,247,497,47,3,true,-1.0
2,1,0.5,0.5,false,false,850,300,847,297,-3,-3,3,true,-1.0
2,1,0.5,0.5,false,false,200,200,200,200,0,0,0,true,-1.0
2,1,0.5,0.5,false,false,300,850,297,847,-3,-3,3,true,-1.0
2,1,0.5,0.5,false,false,300,300,798,898,498,598,2,true,-1.0
2,1,0.5,0.5,false,false,250,300,797,897,547,597,3,true,-1.0
2,2,0.5,0.5,true,true,250,300,799,899,549,599,1,true,350.388
2,2,0.5,0.5,true,true,250,200,947,297,697,97,3,true,-1.0
2,2,0.5,0.5,true,true,250,200,247,197,-3,-3,3,true,-1.0
2,2,0.5,0.5,true,true,300,250,849,849,549,599,1,true,-1.0
2,2,0.5,0.5,true,true,250,850,249,849,-1,-1,1,true,-1.0
2,2,0.5,0.5,true,true,300,350,299,349,-1,-1,1,true,-1.0
2,2,0.5,0.5,true,true,250,200,795,245,545,45,5,true,-1.0
2,2,0.5,0.5,true,true,300,200,896,796,596,596,4,true,-1.0
2,2,0.5,0.5,true,true,200,300,248,898,48,598,2,true,-1.0
2,2,0.5,0.5,true,true,850,200,899,249,49,49,1,false,-1.0
2,2,0.5,0.5,true,false,250,250,249,249,-1,-1,1,true,603.829
2,2,0.5,0.5,true,false,300,250,300,250,0,0,0,true,-1.0
2,2,0.5,0.5,true,false,850,300,849,299,-1,-1,1,true,-1.0
2,2,0.5,0.5,true,false,200,250,199,249,-1,-1,1,false,-1.0
2,2,0.5,0.5,true,false,300,300,296,296,-4,-4,4,true,-1.0
2,2,0.5,0.5,true,false,250,200,249,199,-1,-1,1,true,-1.0
2,2,0.5,0.5,true,false,250,300,249,299,-1,-1,1,true,-1.0
2,2,0.5,0.5,true,false,300,200,349,799,49,599,1,true,-1.0
2,2,0.5,0.5,true,false,200,300,332,882,132,582,18,true,-1.0
2,2,0.5,0.5,true,false,300,350,849,899,549,549,1,true,-1.0
2,2,0.5,0.5,false,true,350,300,398,798,48,498,2,true,303.851
2,2,0.5,0.5,false,true,300,200,298,198,-2,-2,2,true,-1.0
2,2,0.5,0.5,false,true,200,300,200,300,0,0,0,true,-1.0
2,2,0.5,0.5,false,true,350,900,348,898,-2,-2,2,true,-1.0
2,2,0.5,0.5,false,true,350,850,349,849,-1,-1,1,true,-1.0
2,2,0.5,0.5,false,true,350,250,948,798,598,548,2,true,-1.0
2,2,0.5,0.5,false,true,900,900,899,899,-1,-1,1,true,-1.0
2,2,0.5,0.5,false,true,300,200,799,899,499,699,1,true,-1.0
2,2,0.5,0.5,false,true,300,200,349,249,49,49,1,true,-1.0
2,2,0.5,0.5,false,true,300,850,298,848,-2,-2,2,true,-1.0
2,2,0.5,0.5,false,false,200,250,787,287,587,37,13,true,94.742
2,2,0.5,0.5,false,false,850,250,899,299,49,49,1,true,-1.0
2,2,0.5,0.5,false,false,350,350,349,349,-1,-1,1,true,-1.0
2,2,0.5,0.5,false,false,200,850,248,898,48,48,2,true,-1.0
2,2,0.5,0.5,false,false,300,300,297,297,-3,-3,3,true,-1.0
2,2,0.5,0.5,false,false,250,900,249,899,-1,-1,1,true,-1.0
2,2,0.5,0.5,false,false,250,300,298,798,48,498,2,true,-1.0
2,2,0.5,0.5,false,false,250,200,247,197,-3,-3,3,true,-1.0
2,2,0.5,0.5,false,false,250,900,250,900,0,0,0,true,-1.0
2,2,0.5,0.5,false,false,300,200,398,798,98,598,2,true,-1.0
0,0,0.5,0.5,false,false,250,300,298,798,48,498,2,false,0.156
0,0,0.5,0.5,false,false,350,200,347,197,-3,-3,3,false,-1.0
0,0,0.5,0.5,false,false,300,250,298,248,-2,-2,2,true,-1.0
0,0,0.5,0.5,false,false,850,250,898,798,48,548,2,true,-1.0
0,0,0.5,0.5,false,false,250,250,247,247,-3,-3,3,true,-1.0
0,0,0.5,0.5,false,false,350,200,346,196,-4,-4,4,true,-1.0
0,0,0.5,0.5,false,false,250,200,246,196,-4,-4,4,true,-1.0
0,0,0.5,0.5,false,false,850,200,846,196,-4,-4,4,true,-1.0
0,0,0.5,0.5,false,false,250,850,248,848,-2,-2,2,true,-1.0
0,0,0.5,0.5,false,false,300,300,298,298,-2,-2,2,true,-1.0
0,1,0.5,0.5,false,false,300,300,296,296,-4,-4,4,true,0.217
0,1,0.5,0.5,false,false,200,300,197,297,-3,-3,3,true,-1.0
0,1,0.5,0.5,false,false,250,850,247,847,-3,-3,3,true,-1.0
0,1,0.5,0.5,false,false,200,250,248,298,48,48,2,true,-1.0
0,1,0.5,0.5,false,false,300,300,348,898,48,598,2,true,-1.0
0,1,0.5,0.5,false,false,250,850,247,847,-3,-3,3,true,-1.0
0,1,0.5,0.5,false,false,300,300,297,297,-3,-3,3,true,-1.0
0,1,0.5,0.5,false,false,250,250,249,249,-1,-1,1,true,-1.0
0,1,0.5,0.5,false,false,850,200,898,248,48,48,2,true,-1.0
0,1,0.5,0.5,false,false,250,250,298,898,48,648,2,true,-1.0
0,2,0.5,0.5,false,true,250,250,298,848,48,598,2,true,369.865
0,2,0.5,0.5,false,true,300,350,797,397,497,47,3,true,-1.0
0,2,0.5,0.5,false,true,300,200,799,899,499,699,1,true,-1.0
0,2,0.5,0.5,false,true,350,850,346,846,-4,-4,4,true,-1.0
0,2,0.5,0.5,false,true,850,850,849,849,-1,-1,1,true,-1.0
0,2,0.5,0.5,false,true,200,850,248,898,48,48,2,true,-1.0
0,2,0.5,0.5,false,true,200,350,199,349,-1,-1,1,true,-1.0
0,2,0.5,0.5,false,true,350,250,346,246,-4,-4,4,true,-1.0
0,2,0.5,0.5,false,true,250,250,348,798,98,548,2,true,-1.0
0,2,0.5,0.5,false,true,200,850,798,898,598,48,2,true,-1.0
0,2,0.5,0.5,false,false,850,250,846,246,-4,-4,4,true,66.666
0,2,0.5,0.5,false,false,200,250,199,249,-1,-1,1,true,-1.0
0,2,0.5,0.5,false,false,200,300,199,299,-1,-1,1,true,-1.0
0,2,0.5,0.5,false,false,200,300,298,898,98,598,2,true,-1.0
0,2,0.5,0.5,false,false,850,250,846,246,-4,-4,4,true,-1.0
0,2,0.5,0.5,false,false,200,300,298,348,98,48,2,true,-1.0
0,2,0.5,0.5,false,false,300,200,348,798,48,598,2,true,-1.0
0,2,0.5,0.5,false,false,250,300,298,798,48,498,2,true,-1.0
0,2,0.5,0.5,false,false,300,300,799,949,499,649,1,true,-1.0
0,2,0.5,0.5,false,false,250,250,899,849,649,599,1,true,-1.0
1,0,0.5,0.5,false,false,250,850,247,847,-3,-3,3,false,0.285
1,0,0.5,0.5,false,false,200,850,197,847,-3,-3,3,true,-1.0
1,0,0.5,0.5,false,false,300,300,295,295,-5,-5,5,true,-1.0
1,0,0.5,0.5,false,false,300,250,799,299,499,49,1,true,-1.0
1,0,0.5,0.5,false,false,250,300,797,347,547,47,3,true,-1.0
1,0,0.5,0.5,false,false,850,250,850,250,0,0,0,true,-1.0
1,0,0.5,0.5,false,false,300,300,300,300,0,0,0,true,-1.0
1,0,0.5,0.5,false,false,850,200,897,247,47,47,3,false,-1.0
1,0,0.5,0.5,false,false,850,250,845,245,-5,-5,5,true,-1.0
1,0,0.5,0.5,false,false,200,300,248,798,48,498,2,true,-1.0
1,1,0.5,0.5,false,false,250,300,798,348,548,48,2,true,1.244
1,1,0.5,0.5,false,false,250,300,898,798,648,498,2,true,-1.0
1,1,0.5,0.5,false,false,300,250,300,250,0,0,0,true,-1.0
1,1,0.5,0.5,false,false,850,250,898,798,48,548,2,true,-1.0
1,1,0.5,0.5,false,false,200,850,799,899,599,49,1,true,-1.0
1,1,0.5,0.5,false,false,300,200,337,287,37,87,13,true,-1.0
1,1,0.5,0.5,false,false,250,250,848,898,598,648,2,true,-1.0
1,1,0.5,0.5,false,false,850,250,898,798,48,548,2,true,-1.0
1,1,0.5,0.5,false,false,250,350,200,300,-50,-50,50,true,-1.0
1,1,0.5,0.5,false,false,250,300,799,899,549,599,1,true,-1.0
1,2,0.5,0.5,false,true,300,850,298,848,-2,-2,2,true,370.829
1,2,0.5,0.5,false,true,300,250,300,250,0,0,0,true,-1.0
1,2,0.5,0.5,false,true,850,200,850,200,0,0,0,true,-1.0
1,2,0.5,0.5,false,true,300,250,298,248,-2,-2,2,true,-1.0
1,2,0.5,0.5,false,true,300,200,799,899,499,699,1,true,-1.0
1,2,0.5,0.5,false,true,200,250,199,249,-1,-1,1,true,-1.0
1,2,0.5,0.5,false,true,250,250,248,248,-2,-2,2,false,-1.0
1,2,0.5,0.5,false,true,250,250,348,798,98,548,2,true,-1.0
1,2,0.5,0.5,false,true,300,300,849,849,549,549,1,true,-1.0
1,2,0.5,0.5,false,true,250,250,249,249,-1,-1,1,true,-1.0
1,2,0.5,0.5,false,false,250,200,299,299,49,99,1,true,96.8
1,2,0.5,0.5,false,false,200,350,298,898,98,548,2,true,-1.0
1,2,0.5,0.5,false,false,300,250,798,348,498,98,2,true,-1.0
1,2,0.5,0.5,false,false,200,200,249,899,49,699,1,true,-1.0
1,2,0.5,0.5,false,false,300,200,799,249,499,49,1,true,-1.0
1,2,0.5,0.5,false,false,250,250,254,304,4,54,46,true,-1.0
1,2,0.5,0.5,false,false,250,250,250,250,0,0,0,false,-1.0
1,2,0.5,0.5,false,false,200,350,298,898,98,548,2,true,-1.0
1,2,0.5,0.5,false,false,300,850,299,849,-1,-1,1,true,-1.0
1,2,0.5,0.5,false,false,850,250,850,250,0,0,0,true,-1.0
2,0,0.5,0.5,true,false,300,200,297,197,-3,-3,3,true,516.347
2,0,0.5,0.5,true,false,850,850,847,847,-3,-3,3,true,-1.0
2,0,0.5,0.5,true,false,250,850,245,845,-5,-5,5,true,-1.0
2,0,0.5,0.5,true,false,300,250,297,247,-3,-3,3,true,-1.0
2,0,0.5,0.5,true,false,250,250,797,347,547,97,3,true,-1.0
2,0,0.5,0.5,true,false,300,200,799,949,499,749,1,true,-1.0
2,0,0.5,0.5,true,false,300,850,297,847,-3,-3,3,true,-1.0
2,0,0.5,0.5,true,false,350,900,347,897,-3,-3,3,true,-1.0
2,0,0.5,0.5,true,false,300,200,848,898,548,698,2,true,-1.0
2,0,0.5,0.5,true,false,350,250,350,250,0,0,0,true,-1.0
2,0,0.5,0.5,false,false,850,200,848,198,-2,-2,2,true,75.41
2,0,0.5,0.5,false,false,250,250,349,799,99,549,1,true,-1.0
2,0,0.5,0.5,false,false,250,300,247,297,-3,-3,3,true,-1.0
2,0,0.5,0.5,false,false,300,850,297,847,-3,-3,3,true,-1.0
2,0,0.5,0.5,false,false,200,250,299,799,99,549,1,true,-1.0
2,0,0.5,0.5,false,false,250,300,847,847,597,547,3,true,-1.0
2,0,0.5,0.5,false,false,300,300,846,896,546,596,4,true,-1.0
2,0,0.5,0.5,false,false,300,200,295,195,-5,-5,5,true,-1.0
2,0,0.5,0.5,false,false,200,850,197,847,-3,-3,3,true,-1.0
2,0,0.5,0.5,false,false,200,350,195,345,-5,-5,5,false,-1.0
2,1,0.5,0.5,true,false,300,200,300,200,0,0,0,true,623.576
2,1,0.5,0.5,true,false,850,850,847,847,-3,-3,3,true,-1.0
2,1,0.5,0.5,true,false,200,200,197,197,-3,-3,3,true,-1.0
2,1,0.5,0.5,true,false,350,850,347,847,-3,-3,3,true,-1.0
2,1,0.5,0.5,true,false,850,300,847,297,-3,-3,3,true,-1.0
2,1,0.5,0.5,true,false,200,200,200,200,0,0,0,true,-1.0
2,1,0.5,0.5,true,false,250,250,799,299,549,49,1,false,-1.0
2,1,0.5,0.5,true,false,300,300,297,297,-3,-3,3,true,-1.0
2,1,0.5,0.5,true,false,200,200,197,197,-3,-3,3,true,-1.0
2,1,0.5,0.5,true,false,250,250,348,798,98,548,2,true,-1.0
2,1,0.5,0.5,false,false,250,250,849,849,599,599,1,true,109.98
2,1,0.5,0.5,false,false,300,200,898,298,598,98,2,true,-1.0
2,1,0.5,0.5,false,false,200,850,216,866,16,16,34,true,-1.0
2,1,0.5,0.5,false,false,200,250,248,798,48,548,2,true,-1.0
2,1,0.5,0.5,false,false,250,300,247,297,-3,-3,3,true,-1.0
2,1,0.5,0.5,false,false,350,250,350,250,0,0,0,true,-1.0
2,1,0.5,0.5,false,false,250,200,250,200,0,0,0,true,-1.0
2,1,0.5,0.5,false,false,200,200,200,200,0,0,0,true,-1.0
2,1,0.5,0.5,false,false,250,850,258,858,8,8,42,true,-1.0
2,1,0.5,0.5,false,false,250,300,250,300,0,0,0,true,-1.0
2,2,0.5,0.5,true,true,350,850,350,850,0,0,0,true,516.084
2,2,0.5,0.5,true,true,200,250,298,898,98,648,2,false,-1.0
2,2,0.5,0.5,true,true,900,850,899,849,-1,-1,1,true,-1.0
2,2,0.5,0.5,true,true,250,300,248,298,-2,-2,2,true,-1.0
2,2,0.5,0.5,true,true,250,300,250,300,0,0,0,true,-1.0
2,2,0.5,0.5,true,true,300,200,349,799,49,599,1,true,-1.0
2,2,0.5,0.5,true,true,850,850,849,849,-1,-1,1,true,-1.0
2,2,0.5,0.5,true,true,200,200,298,798,98,598,2,true,-1.0
2,2,0.5,0.5,true,true,250,300,397,797,147,497,3,true,-1.0
2,2,0.5,0.5,true,true,350,300,349,299,-1,-1,1,true,-1.0
2,2,0.5,0.5,true,false,200,200,200,200,0,0,0,true,539.053
2,2,0.5,0.5,true,false,300,850,298,848,-2,-2,2,true,-1.0
2,2,0.5,0.5,true,false,300,300,299,299,-1,-1,1,true,-1.0
2,2,0.5,0.5,true,false,200,900,200,900,0,0,0,false,-1.0
2,2,0.5,0.5,true,false,200,300,248,798,48,498,2,true,-1.0
2,2,0.5,0.5,true,false,250,250,799,899,549,649,1,true,-1.0
2,2,0.5,0.5,true,false,850,200,849,199,-1,-1,1,true,-1.0
2,2,0.5,0.5,true,false,300,300,349,799,49,499,1,true,-1.0
2,2,0.5,0.5,true,false,250,200,297,247,47,47,3,true,-1.0
2,2,0.5,0.5,true,false,350,200,350,200,0,0,0,true,-1.0
2,2,0.5,0.5,false,true,300,200,799,349,499,149,1,true,132.924
2,2,0.5,0.5,false,true,250,300,899,899,649,599,1,true,-1.0
2,2,0.5,0.5,false,true,200,300,248,948,48,648,2,true,-1.0
2,2,0.5,0.5,false,true,200,300,798,398,598,98,2,true,-1.0
2,2,0.5,0.5,false,true,300,200,799,249,499,49,1,true,-1.0
2,2,0.5,0.5,false,true,850,250,847,247,-3,-3,3,true,-1.0
2,2,0.5,0.5,false,true,300,300,298,298,-2,-2,2,true,-1.0
2,2,0.5,0.5,false,true,300,300,299,299,-1,-1,1,true,-1.0
2,2,0.5,0.5,false,true,200,200,199,199,-1,-1,1,true,-1.0
2,2,0.5,0.5,false,true,350,200,350,200,0,0,0,true,-1.0
2,2,0.5,0.5,false,false,300,350,299,349,-1,-1,1,true,81.712
2,2,0.5,0.5,false,false,200,300,798,348,598,48,2,true,-1.0
2,2,0.5,0.5,false,false,300,350,299,349,-1,-1,1,true,-1.0
2,2,0.5,0.5,false,false,300,900,799,949,499,49,1,true,-1.0
2,2,0.5,0.5,false,false,250,300,250,300,0,0,0,true,-1.0
2,2,0.5,0.5,false,false,250,300,347,797,97,497,3,true,-1.0
2,2,0.5,0.5,false,false,300,900,299,899,-1,-1,1,true,-1.0
2,2,0.5,0.5,false,false,200,250,298,798,98,548,2,true,-1.0
2,2,0.5,0.5,false,false,200,300,198,298,-2,-2,2,true,-1.0
2,2,0.5,0.5,false,false,200,250,398,798,198,548,2,true,-1.0
0,0,0.5,0.5,false,false,350,200,346,196,-4,-4,4,true,0.177
0,0,0.5,0.5,false,false,250,250,847,347,597,97,3,true,-1.0
0,0,0.5,0.5,false,false,250,250,247,247,-3,-3,3,true,-1.0
0,0,0.5,0.5,false,false,200,350,197,347,-3,-3,3,true,-1.0
0,0,0.5,0.5,false,false,850,350,847,347,-3,-3,3,true,-1.0
0,0,0.5,0.5,false,false,250,200,247,197,-3,-3,3,true,-1.0
0,0,0.5,0.5,false,false,300,250,797,297,497,47,3,false,-1.0
0,0,0.5,0.5,false,false,250,300,298,398,48,98,2,true,-1.0
0,0,0.5,0.5,false,false,300,300,347,797,47,497,3,true,-1.0
0,0,0.5,0.5,false,false,200,250,197,247,-3,-3,3,false,-1.0
0,1,0.5,0.5,false,false,250,250,799,899,549,649,1,true,0.242
0,1,0.5,0.5,false,false,350,300,949,799,599,499,1,true,-1.0
0,1,0.5,0.5,false,false,300,200,296,196,-4,-4,4,true,-1.0
0,1,0.5,0.5,false,false,300,200,296,196,-4,-4,4,true,-1.0
0,1,0.5,0.5,false,false,300,850,297,847,-3,-3,3,true,-1.0
0,1,0.5,0.5,false,false,250,350,246,346,-4,-4,4,false,-1.0
0,1,0.5,0.5,false,false,300,200,296,196,-4,-4,4,true,-1.0
0,1,0.5,0.5,false,false,200,300,248,898,48,598,2,false,-1.0
0,1,0.5,0.5,false,false,200,850,196,846,-4,-4,4,true,-1.0
0,1,0.5,0.5,false,false,300,300,296,296,-4,-4,4,true,-1.0
0,2,0.5,0.5,false,true,250,300,348,798,98,498,2,true,350.579
0,2,0.5,0.5,false,true,250,300,246,296,-4,-4,4,true,-1.0
0,2,0.5,0.5,false,true,200,300,248,348,48,48,2,false,-1.0
0,2,0.5,0.5,false,true,300,300,799,949,499,649,1,true,-1.0
0,2,0.5,0.5,false,true,300,300,296,296,-4,-4,4,true,-1.0
0,2,0.5,0.5,false,true,300,900,797,947,497,47,3,true,-1.0
0,2,0.5,0.5,false,true,250,300,249,299,-1,-1,1,true,-1.0
0,2,0.5,0.5,false,true,300,300,296,296,-4,-4,4,false,-1.0
0,2,0.5,0.5,false,true,250,900,249,899,-1,-1,1,true,-1.0
0,2,0.5,0.5,false,true,300,200,296,196,-4,-4,4,true,-1.0
0,2,0.5,0.5,false,false,850,850,848,848,-2,-2,2,true,53.654
0,2,0.5,0.5,false,false,850,250,848,248,-2,-2,2,true,-1.0
0,2,0.5,0.5,false,false,250,850,249,849,-1,-1,1,true,-1.0
0,2,0.5,0.5,false,false,300,200,296,196,-4,-4,4,true,-1.0
0,2,0.5,0.5,false,false,250,200,298,248,48,48,2,true,-1.0
0,2,0.5,0.5,false,false,250,300,297,797,47,497,3,true,-1.0
0,2,0.5,0.5,false,false,350,200,346,196,-4,-4,4,true,-1.0
0,2,0.5,0.5,false,false,850,250,849,249,-1,-1,1,true,-1.0
0,2,0.5,0.5,false,false,200,350,348,898,148,548,2,true,-1.0
0,2,0.5,0.5,false,false,250,300,246,296,-4,-4,4,true,-1.0
1,0,0.5,0.5,false,false,850,900,850,900,0,0,0,true,0.283
1,0,0.5,0.5,false,false,250,250,248,248,-2,-2,2,true,-1.0
1,0,0.5,0.5,false,false,300,250,797,297,497,47,3,true,-1.0
1,0,0.5,0.5,false,false,850,900,850,900,0,0,0,true,-1.0
1,0,0.5,0.5,false,false,250,350,245,345,-5,-5,5,true,-1.0
1,0,0.5,0.5,false,false,300,300,300,300,0,0,0,true,-1.0
1,0,0.5,0.5,false,false,900,350,897,347,-3,-3,3,true,-1.0
1,0,0.5,0.5,false,false,300,200,797,247,497,47,3,true,-1.0
1,0,0.5,0.5,false,false,200,250,797,297,597,47,3,true,-1.0
1,0,0.5,0.5,false,false,250,350,349,899,99,549,1,true,-1.0
1,1,0.5,0.5,false,false,350,350,899,899,549,549,1,true,1.078
1,1,0.5,0.5,false,false,200,250,197,247,-3,-3,3,true,-1.0
1,1,0.5,0.5,false,false,300,200,799,299,499,99,1,true,-1.0
1,1,0.5,0.5,false,false,300,200,348,248,48,48,2,true,-1.0
1,1,0.5,0.5,false,false,200,250,197,247,-3,-3,3,true,-1.0
1,1,0.5,0.5,false,false,300,250,300,250,0,0,0,true,-1.0
1,1,0.5,0.5,false,false,300,250,799,349,499,99,1,true,-1.0
1,1,0.5,0.5,false,false,200,300,349,799,149,499,1,true,-1.0
1,1,0.5,0.5,false,false,350,200,897,297,547,97,3,true,-1.0
1,1,0.5,0.5,false,false,200,300,249,849,49,549,1,true,-1.0
1,2,0.5,0.5,false,true,300,300,300,300,0,0,0,true,345.305
1,2,0.5,0.5,false,true,250,200,248,198,-2,-2,2,true,-1.0
1,2,0.5,0.5,false,true,250,900,248,898,-2,-2,2,true,-1.0
1,2,0.5,0.5,false,true,300,250,848,898,548,648,2,true,-1.0
1,2,0.5,0.5,false,true,250,350,246,346,-4,-4,4,true,-1.0
1,2,0.5,0.5,false,true,350,300,300,250,-50,-50,50,false,-1.0
1,2,0.5,0.5,false,true,250,200,347,797,97,597,3,true,-1.0
1,2,0.5,0.5,false,true,900,300,949,799,49,499,1,true,-1.0
1,2,0.5,0.5,false,true,350,300,346,296,-4,-4,4,true,-1.0
1,2,0.5,0.5,false,true,300,250,300,250,0,0,0,false,-1.0
1,2,0.5,0.5,false,false,200,300,198,298,-2,-2,2,true,116.303
1,2,0.5,0.5,false,false,850,850,848,848,-2,-2,2,true,-1.0
1,2,0.5,0.5,false,false,200,850,249,899,49,49,1,true,-1.0
1,2,0.5,0.5,false,false,200,300,891,341,691,41,9,true,-1.0
1,2,0.5,0.5,false,false,300,200,799,299,499,99,1,true,-1.0
1,2,0.5,0.5,false,false,350,200,891,291,541,91,9,true,-1.0
1,2,0.5,0.5,false,false,250,250,249,249,-1,-1,1,true,-1.0
1,2,0.5,0.5,false,false,200,250,198,248,-2,-2,2,true,-1.0
1,2,0.5,0.5,false,false,200,300,200,300,0,0,0,true,-1.0
1,2,0.5,0.5,false,false,300,250,300,250,0,0,0,true,-1.0
2,0,0.5,0.5,true,false,900,300,895,295,-5,-5,5,true,559.63
2,0,0.5,0.5,true,false,300,250,295,245,-5,-5,5,false,-1.0
2,0,0.5,0.5,true,false,850,300,850,300,0,0,0,true,-1.0
2,0,0.5,0.5,true,false,300,300,797,347,497,47,3,true,-1.0
2,0,0.5,0.5,true,false,300,350,799,399,499,49,1,true,-1.0
2,0,0.5,0.5,true,false,850,200,850,200,0,0,0,true,-1.0
2,0,0.5,0.5,true,false,300,250,897,297,597,47,3,true,-1.0
2,0,0.5,0.5,true,false,200,250,200,250,0,0,0,true,-1.0
2,0,0.5,0.5,true,false,250,850,247,847,-3,-3,3,true,-1.0
2,0,0.5,0.5,true,false,300,300,349,799,49,499,1,true,-1.0
2,0,0.5,0.5,false,false,200,850,197,847,-3,-3,3,true,71.388
2,0,0.5,0.5,false,false,300,300,797,347,497,47,3,true,-1.0
2,0,0.5,0.5,false,false,300,300,296,296,-4,-4,4,true,-1.0
2,0,0.5,0.5,false,false,350,350,345,345,-5,-5,5,true,-1.0
2,0,0.5,0.5,false,false,200,250,247,297,47,47,3,true,-1.0
2,0,0.5,0.5,false,false,850,200,850,200,0,0,0,true,-1.0
2,0,0.5,0.5,false,false,300,200,799,349,499,149,1,true,-1.0
2,0,0.5,0.5,false,false,900,200,900,200,0,0,0,true,-1.0
2,0,0.5,0.5,false,false,850,850,847,847,-3,-3,3,true,-1.0
2,0,0.5,0.5,false,false,300,300,797,897,497,597,3,true,-1.0
2,1,0.5,0.5,true,false,300,250,797,397,497,147,3,true,1085.284
2,1,0.5,0.5,true,false,300,250,796,296,496,46,4,true,-1.0
2,1,0.5,0.5,true,false,300,300,250,250,-50,-50,50,false,-1.0
2,1,0.5,0.5,true,false,300,300,798,798,498,498,2,true,-1.0
2,1,0.5,0.5,true,false,850,200,850,200,0,0,0,true,-1.0
2,1,0.5,0.5,true,false,300,200,796,296,496,96,4,true,-1.0
2,1,0.5,0.5,true,false,350,250,345,245,-5,-5,5,true,-1.0
2,1,0.5,0.5,true,false,250,300,299,349,49,49,1,true,-1.0
2,1,0.5,0.5,true,false,300,200,300,200,0,0,0,true,-1.0
2,1,0.5,0.5,true,false,300,250,300,250,0,0,0,true,-1.0
2,1,0.5,0.5,false,false,200,250,799,299,599,49,1,true,133.733
2,1,0.5,0.5,false,false,300,250,796,396,496,146,4,true,-1.0
2,1,0.5,0.5,false,false,300,300,799,899,499,599,1,true,-1.0
2,1,0.5,0.5,false,false,250,850,247,847,-3,-3,3,true,-1.0
2,1,0.5,0.5,false,false,900,300,899,299,-1,-1,1,true,-1.0
2,1,0.5,0.5,false,false,300,350,799,399,499,49,1,true,-1.0
2,1,0.5,0.5,false,false,250,200,247,197,-3,-3,3,true,-1.0
2,1,0.5,0.5,false,false,250,300,237,287,-13,-13,13,true,-1.0
2,1,0.5,0.5,false,false,200,300,197,297,-3,-3,3,true,-1.0
2,1,0.5,0.5,false,false,850,200,850,200,0,0,0,true,-1.0
2,2,0.5,0.5,true,true,200,200,199,199,-1,-1,1,true,571.551
2,2,0.5,0.5,true,true,250,300,797,947,547,647,3,true,-1.0
2,2,0.5,0.5,true,true,300,250,299,249,-1,-1,1,true,-1.0
2,2,0.5,0.5,true,true,300,250,897,297,597,47,3,true,-1.0
2,2,0.5,0.5,true,true,250,200,899,249,649,49,1,true,-1.0
2,2,0.5,0.5,true,true,200,200,200,200,0,0,0,true,-1.0
2,2,0.5,0.5,true,true,850,850,850,850,0,0,0,true,-1.0
2,2,0.5,0.5,true,true,850,200,899,799,49,599,1,true,-1.0
2,2,0.5,0.5,true,true,250,850,249,849,-1,-1,1,true,-1.0
2,2,0.5,0.5,true,true,250,300,799,349,549,49,1,true,-1.0
2,2,0.5,0.5,true,false,250,250,250,250,0,0,0,true,485.028
2,2,0.5,0.5,true,false,200,250,199,249,-1,-1,1,true,-1.0
2,2,0.5,0.5,true,false,250,350,249,349,-1,-1,1,true,-1.0
2,2,0.5,0.5,true,false,250,900,249,899,-1,-1,1,true,-1.0
2,2,0.5,0.5,true,false,850,850,849,849,-1,-1,1,true,-1.0
2,2,0.5,0.5,true,false,850,250,899,299,49,49,1,true,-1.0
2,2,0.5,0.5,true,false,200,850,798,898,598,48,2,true,-1.0
2,2,0.5,0.5,true,false,350,200,898,248,548,48,2,true,-1.0
2,2,0.5,0.5,true,false,300,250,300,250,0,0,0,true,-1.0
2,2,0.5,0.5,true,false,200,200,199,199,-1,-1,1,true,-1.0
2,2,0.5,0.5,false,true,250,300,899,799,649,499,1,true,197.638
2,2,0.5,0.5,false,true,300,300,798,348,498,48,2,true,-1.0
2,2,0.5,0.5,false,true,350,300,348,298,-2,-2,2,true,-1.0
2,2,0.5,0.5,false,true,850,200,849,199,-1,-1,1,true,-1.0
2,2,0.5,0.5,false,true,300,300,798,898,498,598,2,true,-1.0
2,2,0.5,0.5,false,true,300,850,798,898,498,48,2,true,-1.0
2,2,0.5,0.5,false,true,300,200,847,297,547,97,3,true,-1.0
2,2,0.5,0.5,false,true,850,250,850,250,0,0,0,true,-1.0
2,2,0.5,0.5,false,true,300,200,297,197,-3,-3,3,true,-1.0
2,2,0.5,0.5,false,true,350,300,350,300,0,0,0,true,-1.0
2,2,0.5,0.5,false,false,350,250,350,250,0,0,0,true,81.301
2,2,0.5,0.5,false,false,250,200,250,200,0,0,0,true,-1.0
2,2,0.5,0.5,false,false,250,300,248,298,-2,-2,2,true,-1.0
2,2,0.5,0.5,false,false,300,250,798,948,498,698,2,true,-1.0
2,2,0.5,0.5,false,false,350,350,346,346,-4,-4,4,true,-1.0
2,2,0.5,0.5,false,false,250,250,797,297,547,47,3,true,-1.0
2,2,0.5,0.5,false,false,250,300,298,798,48,498,2,true,-1.0
2,2,0.5,0.5,false,false,300,300,798,398,498,98,2,true,-1.0
2,2,0.5,0.5,false,false,250,300,797,347,547,47,3,true,-1.0
2,2,0.5,0.5,false,false,850,850,849,849,-1,-1,1,true,-1.0
0,0,0.5,0.5,false,false,850,200,896,796,46,596,4,true,0.149
0,0,0.5,0.5,false,false,200,250,247,347,47,97,3,true,-1.0
0,0,0.5,0.5,false,false,250,850,247,847,-3,-3,3,true,-1.0
0,0,0.5,0.5,false,false,200,200,198,198,-2,-2,2,true,-1.0
0,0,0.5,0.5,false,false,850,300,848,298,-2,-2,2,true,-1.0
0,0,0.5,0.5,false,false,200,200,197,197,-3,-3,3,true,-1.0
0,0,0.5,0.5,false,false,250,200,247,197,-3,-3,3,true,-1.0
0,0,0.5,0.5,false,false,850,300,847,297,-3,-3,3,true,-1.0
0,0,0.5,0.5,false,false,200,250,197,247,-3,-3,3,true,-1.0
0,0,0.5,0.5,false,false,250,850,247,847,-3,-3,3,true,-1.0
0,1,0.5,0.5,false,false,250,300,246,296,-4,-4,4,true,0.233
0,1,0.5,0.5,false,false,200,300,248,898,48,598,2,false,-1.0
0,1,0.5,0.5,false,false,850,250,846,246,-4,-4,4,true,-1.0
0,1,0.5,0.5,false,false,200,850,197,847,-3,-3,3,true,-1.0
0,1,0.5,0.5,false,false,300,850,799,899,499,49,1,true,-1.0
0,1,0.5,0.5,false,false,250,200,246,196,-4,-4,4,true,-1.0
0,1,0.5,0.5,false,false,850,250,846,246,-4,-4,4,true,-1.0
0,1,0.5,0.5,false,false,200,200,248,798,48,598,2,true,-1.0
0,1,0.5,0.5,false,false,850,300,849,299,-1,-1,1,true,-1.0
0,1,0.5,0.5,false,false,300,200,797,347,497,147,3,true,-1.0
0,2,0.5,0.5,false,true,250,250,247,247,-3,-3,3,true,386.654
0,2,0.5,0.5,false,true,200,850,798,898,598,48,2,true,-1.0
0,2,0.5,0.5,false,true,300,250,298,248,-2,-2,2,true,-1.0
0,2,0.5,0.5,false,true,850,250,846,246,-4,-4,4,true,-1.0
0,2,0.5,0.5,false,true,900,300,896,296,-4,-4,4,true,-1.0
0,2,0.5,0.5,false,true,250,200,298,798,48,598,2,true,-1.0
0,2,0.5,0.5,false,true,300,200,296,196,-4,-4,4,true,-1.0
0,2,0.5,0.5,false,true,200,200,196,196,-4,-4,4,true,-1.0
0,2,0.5,0.5,false,true,250,250,246,246,-4,-4,4,true,-1.0
0,2,0.5,0.5,false,true,350,250,398,798,48,548,2,true,-1.0
0,2,0.5,0.5,false,false,300,300,299,299,-1,-1,1,true,66.46
0,2,0.5,0.5,false,false,250,200,249,199,-1,-1,1,true,-1.0
0,2,0.5,0.5,false,false,850,200,846,196,-4,-4,4,false,-1.0
0,2,0.5,0.5,false,false,350,850,346,846,-4,-4,4,true,-1.0
0,2,0.5,0.5,false,false,350,200,346,196,-4,-4,4,true,-1.0
0,2,0.5,0.5,false,false,200,250,298,798,98,548,2,true,-1.0
0,2,0.5,0.5,false,false,350,200,346,196,-4,-4,4,true,-1.0
0,2,0.5,0.5,false,false,200,200,196,196,-4,-4,4,true,-1.0
0,2,0.5,0.5,false,false,300,250,797,297,497,47,3,true,-1.0
0,2,0.5,0.5,false,false,250,250,249,249,-1,-1,1,true,-1.0
1,0,0.5,0.5,false,false,350,850,347,847,-3,-3,3,true,0.281
1,0,0.5,0.5,false,false,200,200,197,197,-3,-3,3,true,-1.0
1,0,0.5,0.5,false,false,200,250,249,799,49,549,1,true,-1.0
1,0,0.5,0.5,false,false,250,350,797,397,547,47,3,true,-1.0
1,0,0.5,0.5,false,false,250,350,250,350,0,0,0,true,-1.0
1,0,0.5,0.5,false,false,350,350,347,347,-3,-3,3,true,-1.0
1,0,0.5,0.5,false,false,250,250,299,799,49,549,1,true,-1.0
1,0,0.5,0.5,false,false,200,300,197,297,-3,-3,3,true,-1.0
1,0,0.5,0.5,false,false,900,200,947,247,47,47,3,true,-1.0
1,0,0.5,0.5,false,false,250,850,247,847,-3,-3,3,true,-1.0
1,1,0.5,0.5,false,false,200,250,200,250,0,0,0,true,0.984
1,1,0.5,0.5,false,false,250,350,299,899,49,549,1,true,-1.0
1,1,0.5,0.5,false,false,250,350,247,347,-3,-3,3,true,-1.0
1,1,0.5,0.5,false,false,200,200,150,150,-50,-50,50,false,-1.0
1,1,0.5,0.5,false,false,300,350,250,300,-50,-50,50,true,-1.0
1,1,0.5,0.5,false,false,850,250,800,200,-50,-50,50,true,-1.0
1,1,0.5,0.5,false,false,850,850,800,800,-50,-50,50,true,-1.0
1,1,0.5,0.5,false,false,350,300,300,250,-50,-50,50,true,-1.0
1,1,0.5,0.5,false,false,250,200,200,150,-50,-50,50,false,-1.0
1,1,0.5,0.5,false,false,850,300,800,250,-50,-50,50,true,-1.0
1,2,0.5,0.5,false,true,250,200,299,299,49,99,1,false,771.207
1,2,0.5,0.5,false,true,850,250,898,298,48,48,2,true,-1.0
1,2,0.5,0.5,false,true,300,350,298,348,-2,-2,2,true,-1.0
1,2,0.5,0.5,false,true,350,350,347,347,-3,-3,3,true,-1.0
1,2,0.5,0.5,false,true,200,200,797,297,597,97,3,true,-1.0
1,2,0.5,0.5,false,true,200,300,249,899,49,599,1,true,-1.0
1,2,0.5,0.5,false,true,350,250,344,244,-6,-6,6,true,-1.0
1,2,0.5,0.5,false,true,350,850,350,850,0,0,0,true,-1.0
1,2,0.5,0.5,false,true,200,250,248,848,48,598,2,false,-1.0
1,2,0.5,0.5,false,true,300,850,298,848,-2,-2,2,true,-1.0
1,2,0.5,0.5,false,false,300,250,799,899,499,649,1,true,57.443
1,2,0.5,0.5,false,false,200,300,298,848,98,548,2,true,-1.0
1,2,0.5,0.5,false,false,300,200,331,231,31,31,19,true,-1.0
1,2,0.5,0.5,false,false,250,350,298,898,48,548,2,true,-1.0
1,2,0.5,0.5,false,false,250,200,799,799,549,599,1,false,-1.0
1,2,0.5,0.5,false,false,250,200,881,231,631,31,19,true,-1.0
1,2,0.5,0.5,false,false,850,200,850,200,0,0,0,true,-1.0
1,2,0.5,0.5,false,false,300,250,250,200,-50,-50,50,false,-1.0
1,2,0.5,0.5,false,false,250,250,250,250,0,0,0,true,-1.0
1,2,0.5,0.5,false,false,300,300,298,298,-2,-2,2,true,-1.0
2,0,0.5,0.5,true,false,300,300,898,848,598,548,2,true,535.673
2,0,0.5,0.5,true,false,250,250,245,245,-5,-5,5,false,-1.0
2,0,0.5,0.5,true,false,300,350,848,898,548,548,2,true,-1.0
2,0,0.5,0.5,true,false,300,300,349,799,49,499,1,true,-1.0
2,0,0.5,0.5,true,false,250,850,247,847,-3,-3,3,true,-1.0
2,0,0.5,0.5,true,false,250,300,250,300,0,0,0,true,-1.0
2,0,0.5,0.5,true,false,250,300,849,849,599,549,1,true,-1.0
2,0,0.5,0.5,true,false,250,250,797,297,547,47,3,true,-1.0
2,0,0.5,0.5,true,false,300,200,897,247,597,47,3,true,-1.0
2,0,0.5,0.5,true,false,300,300,797,347,497,47,3,true,-1.0
2,0,0.5,0.5,false,false,250,350,247,347,-3,-3,3,true,81.079
2,0,0.5,0.5,false,false,300,250,797,347,497,97,3,true,-1.0
2,0,0.5,0.5,false,false,250,250,247,247,-3,-3,3,true,-1.0
2,0,0.5,0.5,false,false,250,300,247,297,-3,-3,3,true,-1.0
2,0,0.5,0.5,false,false,300,300,300,300,0,0,0,true,-1.0
2,0,0.5,0.5,false,false,250,350,296,896,46,546,4,true,-1.0
2,0,0.5,0.5,false,false,900,850,900,850,0,0,0,true,-1.0
2,0,0.5,0.5,false,false,250,300,296,796,46,496,4,true,-1.0
2,0,0.5,0.5,false,false,250,200,250,200,0,0,0,true,-1.0
2,0,0.5,0.5,false,false,300,300,346,796,46,496,4,true,-1.0
2,1,0.5,0.5,true,false,200,300,799,349,599,49,1,true,1009.586
2,1,0.5,0.5,true,false,300,850,299,849,-1,-1,1,true,-1.0
2,1,0.5,0.5,true,false,900,250,897,247,-3,-3,3,true,-1.0
2,1,0.5,0.5,true,false,300,300,799,899,499,599,1,true,-1.0
2,1,0.5,0.5,true,false,300,250,898,298,598,48,2,true,-1.0
2,1,0.5,0.5,true,false,200,300,197,297,-3,-3,3,true,-1.0
2,1,0.5,0.5,true,false,200,200,200,200,0,0,0,true,-1.0
2,1,0.5,0.5,true,false,900,900,897,897,-3,-3,3,true,-1.0
2,1,0.5,0.5,true,false,200,300,197,297,-3,-3,3,true,-1.0
2,1,0.5,0.5,true,false,200,200,299,249,99,49,1,true,-1.0
2,1,0.5,0.5,false,false,250,300,849,849,599,549,1,true,135.332
2,1,0.5,0.5,false,false,250,350,247,347,-3,-3,3,true,-1.0
2,1,0.5,0.5,false,false,850,250,847,247,-3,-3,3,true,-1.0
2,1,0.5,0.5,false,false,300,250,297,247,-3,-3,3,true,-1.0
2,1,0.5,0.5,false,false,200,350,200,350,0,0,0,true,-1.0
2,1,0.5,0.5,false,false,850,300,898,798,48,498,2,true,-1.0
2,1,0.5,0.5,false,false,200,250,197,247,-3,-3,3,true,-1.0
2,1,0.5,0.5,false,false,300,200,297,197,-3,-3,3,true,-1.0
2,1,0.5,0.5,false,false,200,350,150,300,-50,-50,50,false,-1.0
2,1,0.5,0.5,false,false,250,300,200,250,-50,-50,50,false,-1.0
2,2,0.5,0.5,true,true,300,350,796,396,496,46,4,true,342.667
2,2,0.5,0.5,true,true,250,250,849,899,599,649,1,true,-1.0
2,2,0.5,0.5,true,true,200,250,200,250,0,0,0,true,-1.0
2,2,0.5,0.5,true,true,300,300,300,300,0,0,0,true,-1.0
2,2,0.5,0.5,true,true,250,200,247,197,-3,-3,3,true,-1.0
2,2,0.5,0.5,true,true,200,850,200,850,0,0,0,true,-1.0
2,2,0.5,0.5,true,true,300,300,300,300,0,0,0,false,-1.0
2,2,0.5,0.5,true,true,300,300,799,399,499,99,1,true,-1.0
2,2,0.5,0.5,true,true,900,850,899,849,-1,-1,1,true,-1.0
2,2,0.5,0.5,true,true,300,250,899,799,599,549,1,true,-1.0
2,2,0.5,0.5,true,false,300,300,299,299,-1,-1,1,true,328.133
2,2,0.5,0.5,true,false,200,350,899,899,699,549,1,true,-1.0
2,2,0.5,0.5,true,false,350,850,350,850,0,0,0,true,-1.0
2,2,0.5,0.5,true,false,250,300,798,348,548,48,2,true,-1.0
2,2,0.5,0.5,true,false,250,850,798,898,548,48,2,true,-1.0
2,2,0.5,0.5,true,false,300,300,299,299,-1,-1,1,true,-1.0
2,2,0.5,0.5,true,false,350,250,899,299,549,49,1,true,-1.0
2,2,0.5,0.5,true,false,250,200,797,347,547,147,3,true,-1.0
2,2,0.5,0.5,true,false,300,850,299,849,-1,-1,1,true,-1.0
2,2,0.5,0.5,true,false,250,250,848,848,598,598,2,true,-1.0
2,2,0.5,0.5,false,true,250,200,898,798,648,598,2,true,203.788
2,2,0.5,0.5,false,true,250,300,298,798,48,498,2,true,-1.0
2,2,0.5,0.5,false,true,350,900,349,899,-1,-1,1,true,-1.0
2,2,0.5,0.5,false,true,850,200,899,249,49,49,1,true,-1.0
2,2,0.5,0.5,false,true,200,300,798,348,598,48,2,true,-1.0
2,2,0.5,0.5,false,true,850,200,898,298,48,98,2,true,-1.0
2,2,0.5,0.5,false,true,850,200,899,249,49,49,1,true,-1.0
2,2,0.5,0.5,false,true,350,300,350,300,0,0,0,true,-1.0
2,2,0.5,0.5,false,true,300,250,298,248,-2,-2,2,true,-1.0
2,2,0.5,0.5,false,true,200,850,247,897,47,47,3,true,-1.0
2,2,0.5,0.5,false,false,850,300,850,300,0,0,0,true,78.754
2,2,0.5,0.5,false,false,250,250,249,249,-1,-1,1,true,-1.0
2,2,0.5,0.5,false,false,850,350,849,349,-1,-1,1,true,-1.0
2,2,0.5,0.5,false,false,250,250,299,299,49,49,1,true,-1.0
2,2,0.5,0.5,false,false,350,300,349,299,-1,-1,1,true,-1.0
2,2,0.5,0.5,false,false,850,300,898,798,48,498,2,true,-1.0
2,2,0.5,0.5,false,false,200,250,197,247,-3,-3,3,true,-1.0
2,2,0.5,0.5,false,false,850,850,849,849,-1,-1,1,true,-1.0
2,2,0.5,0.5,false,false,850,850,849,849,-1,-1,1,true,-1.0
2,2,0.5,0.5,false,false,200,250,248,248,48,-2,2,true,-1.0
0,0,0.5,0.5,false,false,250,300,799,399,549,99,1,true,0.15
0,0,0.5,0.5,false,false,200,300,246,796,46,496,4,true,-1.0
0,0,0.5,0.5,false,false,850,850,848,848,-2,-2,2,true,-1.0
0,0,0.5,0.5,false,false,350,850,347,847,-3,-3,3,true,-1.0
0,0,0.5,0.5,false,false,300,300,346,796,46,496,4,true,-1.0
0,0,0.5,0.5,false,false,300,300,298,298,-2,-2,2,true,-1.0
0,0,0.5,0.5,false,false,200,200,197,197,-3,-3,3,true,-1.0
0,0,0.5,0.5,false,false,200,300,197,297,-3,-3,3,true,-1.0
0,0,0.5,0.5,false,false,200,300,197,297,-3,-3,3,true,-1.0
0,0,0.5,0.5,false,false,300,300,296,296,-4,-4,4,true,-1.0
0,1,0.5,0.5,false,false,300,250,298,248,-2,-2,2,true,0.264
0,1,0.5,0.5,false,false,300,300,296,296,-4,-4,4,true,-1.0
0,1,0.5,0.5,false,false,250,300,246,296,-4,-4,4,true,-1.0
0,1,0.5,0.5,false,false,300,300,296,296,-4,-4,4,false,-1.0
0,1,0.5,0.5,false,false,300,300,348,798,48,498,2,true,-1.0
0,1,0.5,0.5,false,false,300,850,296,846,-4,-4,4,true,-1.0
0,1,0.5,0.5,false,false,200,300,298,798,98,498,2,true,-1.0
0,1,0.5,0.5,false,false,350,200,346,196,-4,-4,4,true,-1.0
0,1,0.5,0.5,false,false,200,300,799,399,599,99,1,true,-1.0
0,1,0.5,0.5,false,false,850,300,898,798,48,498,2,true,-1.0
0,2,0.5,0.5,false,true,300,200,799,349,499,149,1,true,340.78
0,2,0.5,0.5,false,true,850,850,848,848,-2,-2,2,true,-1.0
0,2,0.5,0.5,false,true,200,300,248,798,48,498,2,true,-1.0
0,2,0.5,0.5,false,true,300,300,296,296,-4,-4,4,true,-1.0
0,2,0.5,0.5,false,true,200,300,298,898,98,598,2,true,-1.0
0,2,0.5,0.5,false,true,850,850,846,846,-4,-4,4,true,-1.0
0,2,0.5,0.5,false,true,200,300,197,297,-3,-3,3,true,-1.0
0,2,0.5,0.5,false,true,250,250,246,246,-4,-4,4,true,-1.0
0,2,0.5,0.5,false,true,200,300,248,798,48,498,2,true,-1.0
0,2,0.5,0.5,false,true,300,250,296,246,-4,-4,4,true,-1.0
0,2,0.5,0.5,false,false,200,850,196,846,-4,-4,4,true,54.569
0,2,0.5,0.5,false,false,300,300,296,296,-4,-4,4,true,-1.0
0,2,0.5,0.5,false,false,200,250,348,798,148,548,2,true,-1.0
0,2,0.5,0.5,false,false,200,350,296,396,96,46,4,true,-1.0
0,2,0.5,0.5,false,false,300,350,797,947,497,597,3,true,-1.0
0,2,0.5,0.5,false,false,850,200,898,798,48,598,2,true,-1.0
0,2,0.5,0.5,false,false,250,850,298,898,48,48,2,true,-1.0
0,2,0.5,0.5,false,false,250,200,249,199,-1,-1,1,true,-1.0
0,2,0.5,0.5,false,false,300,300,299,299,-1,-1,1,true,-1.0
0,2,0.5,0.5,false,false,300,300,797,397,497,97,3,true,-1.0
1,0,0.5,0.5,false,false,200,250,897,297,697,47,3,true,0.265
1,0,0.5,0.5,false,false,300,250,797,297,497,47,3,false,-1.0
1,0,0.5,0.5,false,false,900,200,900,200,0,0,0,true,-1.0
1,0,0.5,0.5,false,false,300,300,295,295,-5,-5,5,true,-1.0
1,0,0.5,0.5,false,false,200,300,200,300,0,0,0,true,-1.0
1,0,0.5,0.5,false,false,200,850,200,850,0,0,0,true,-1.0
1,0,0.5,0.5,false,false,300,300,797,347,497,47,3,true,-1.0
1,0,0.5,0.5,false,false,300,350,848,898,548,548,2,true,-1.0
1,0,0.5,0.5,false,false,250,300,247,297,-3,-3,3,true,-1.0
1,0,0.5,0.5,false,false,300,300,300,300,0,0,0,true,-1.0
1,1,0.5,0.5,false,false,250,250,200,200,-50,-50,50,true,0.967
1,1,0.5,0.5,false,false,250,250,247,247,-3,-3,3,true,-1.0
1,1,0.5,0.5,false,false,300,850,297,847,-3,-3,3,true,-1.0
1,1,0.5,0.5,false,false,300,250,795,295,495,45,5,true,-1.0
1,1,0.5,0.5,false,false,850,300,848,298,-2,-2,2,true,-1.0
1,1,0.5,0.5,false,false,300,250,849,299,549,49,1,true,-1.0
1,1,0.5,0.5,false,false,250,200,200,150,-50,-50,50,true,-1.0
1,1,0.5,0.5,false,false,850,200,850,200,0,0,0,true,-1.0
1,1,0.5,0.5,false,false,850,300,800,250,-50,-50,50,true,-1.0
1,1,0.5,0.5,false,false,200,250,200,250,0,0,0,true,-1.0
1,2,0.5,0.5,false,true,300,250,398,798,98,548,2,true,518.746
1,2,0.5,0.5,false,true,350,850,348,848,-2,-2,2,true,-1.0
1,2,0.5,0.5,false,true,850,300,899,799,49,499,1,true,-1.0
1,2,0.5,0.5,false,true,900,300,949,799,49,499,1,true,-1.0
1,2,0.5,0.5,false,true,250,300,248,298,-2,-2,2,false,-1.0
1,2,0.5,0.5,false,true,300,300,799,349,499,49,1,true,-1.0
1,2,0.5,0.5,false,true,300,850,799,899,499,49,1,true,-1.0
1,2,0.5,0.5,false,true,850,300,848,298,-2,-2,2,true,-1.0
1,2,0.5,0.5,false,true,300,850,799,899,499,49,1,true,-1.0
1,2,0.5,0.5,false,true,300,250,298,248,-2,-2,2,true,-1.0
1,2,0.5,0.5,false,false,250,350,781,381,531,31,19,true,84.651
1,2,0.5,0.5,false,false,850,300,838,288,-12,-12,12,true,-1.0
1,2,0.5,0.5,false,false,250,850,248,848,-2,-2,2,true,-1.0
1,2,0.5,0.5,false,false,900,250,900,250,0,0,0,true,-1.0
1,2,0.5,0.5,false,false,200,250,200,250,0,0,0,false,-1.0
1,2,0.5,0.5,false,false,250,300,299,799,49,499,1,true,-1.0
1,2,0.5,0.5,false,false,850,200,850,200,0,0,0,true,-1.0
1,2,0.5,0.5,false,false,350,300,348,298,-2,-2,2,true,-1.0
1,2,0.5,0.5,false,false,350,200,946,796,596,596,4,true,-1.0
1,2,0.5,0.5,false,false,250,300,248,298,-2,-2,2,true,-1.0
2,0,0.5,0.5,true,false,250,300,348,798,98,498,2,true,529.325
2,0,0.5,0.5,true,false,300,250,297,247,-3,-3,3,true,-1.0
2,0,0.5,0.5,true,false,250,300,245,295,-5,-5,5,false,-1.0
2,0,0.5,0.5,true,false,300,900,297,897,-3,-3,3,false,-1.0
2,0,0.5,0.5,true,false,200,850,197,847,-3,-3,3,true,-1.0
2,0,0.5,0.5,true,false,300,300,297,297,-3,-3,3,false,-1.0
2,0,0.5,0.5,true,false,850,250,897,297,47,47,3,true,-1.0
2,0,0.5,0.5,true,false,300,250,295,245,-5,-5,5,true,-1.0
2,0,0.5,0.5,true,false,300,200,297,197,-3,-3,3,true,-1.0
2,0,0.5,0.5,true,false,850,300,848,298,-2,-2,2,true,-1.0
2,0,0.5,0.5,false,false,300,900,796,946,496,46,4,true,91.137
2,0,0.5,0.5,false,false,250,850,247,847,-3,-3,3,false,-1.0
2,0,0.5,0.5,false,false,250,250,246,246,-4,-4,4,true,-1.0
2,0,0.5,0.5,false,false,250,300,250,300,0,0,0,true,-1.0
2,0,0.5,0.5,false,false,300,250,349,299,49,49,1,true,-1.0
2,0,0.5,0.5,false,false,300,300,348,798,48,498,2,true,-1.0
2,0,0.5,0.5,false,false,200,200,948,798,748,598,2,true,-1.0
2,0,0.5,0.5,false,false,300,350,797,397,497,47,3,false,-1.0
2,0,0.5,0.5,false,false,200,200,249,249,49,49,1,true,-1.0
2,0,0.5,0.5,false,false,900,300,949,799,49,499,1,true,-1.0
2,1,0.5,0.5,true,false,850,300,899,799,49,499,1,true,1090.526
2,1,0.5,0.5,true,false,300,850,295,845,-5,-5,5,true,-1.0
2,1,0.5,0.5,true,false,300,250,799,299,499,49,1,true,-1.0
2,1,0.5,0.5,true,false,300,200,899,349,599,149,1,true,-1.0
2,1,0.5,0.5,true,false,250,850,247,847,-3,-3,3,true,-1.0
2,1,0.5,0.5,true,false,200,300,295,345,95,45,5,true,-1.0
2,1,0.5,0.5,true,false,200,300,197,297,-3,-3,3,true,-1.0
2,1,0.5,0.5,true,false,350,200,399,299,49,99,1,true,-1.0
2,1,0.5,0.5,true,false,250,850,247,847,-3,-3,3,true,-1.0
2,1,0.5,0.5,true,false,250,350,797,397,547,47,3,true,-1.0
2,1,0.5,0.5,false,false,200,300,898,848,698,548,2,true,108.945
2,1,0.5,0.5,false,false,250,250,795,895,545,645,5,true,-1.0
2,1,0.5,0.5,false,false,900,300,897,297,-3,-3,3,true,-1.0
2,1,0.5,0.5,false,false,250,300,299,799,49,499,1,true,-1.0
2,1,0.5,0.5,false,false,250,300,200,250,-50,-50,50,false,-1.0
2,1,0.5,0.5,false,false,250,250,247,247,-3,-3,3,true,-1.0
2,1,0.5,0.5,false,false,200,200,197,197,-3,-3,3,true,-1.0
2,1,0.5,0.5,false,false,250,850,237,837,-13,-13,13,true,-1.0
2,1,0.5,0.5,false,false,300,250,848,898,548,648,2,true,-1.0
2,1,0.5,0.5,false,false,850,250,898,298,48,48,2,true,-1.0
2,2,0.5,0.5,true,true,200,250,247,847,47,597,3,true,567.914
2,2,0.5,0.5,true,true,850,300,849,299,-1,-1,1,true,-1.0
2,2,0.5,0.5,true,true,900,300,900,300,0,0,0,true,-1.0
2,2,0.5,0.5,true,true,200,300,199,299,-1,-1,1,true,-1.0
2,2,0.5,0.5,true,true,300,250,298,248,-2,-2,2,true,-1.0
2,2,0.5,0.5,true,true,850,200,849,199,-1,-1,1,true,-1.0
2,2,0.5,0.5,true,true,200,250,150,200,-50,-50,50,false,-1.0
2,2,0.5,0.5,true,true,300,250,799,349,499,99,1,true,-1.0
2,2,0.5,0.5,true,true,250,850,248,848,-2,-2,2,true,-1.0
2,2,0.5,0.5,true,true,250,250,249,249,-1,-1,1,true,-1.0
2,2,0.5,0.5,true,false,200,850,798,898,598,48,2,true,397.636
2,2,0.5,0.5,true,false,900,200,900,200,0,0,0,true,-1.0
2,2,0.5,0.5,true,false,300,250,847,297,547,47,3,true,-1.0
2,2,0.5,0.5,true,false,250,200,200,150,-50,-50,50,false,-1.0
2,2,0.5,0.5,true,false,300,250,299,249,-1,-1,1,true,-1.0
2,2,0.5,0.5,true,false,300,900,799,949,499,49,1,true,-1.0
2,2,0.5,0.5,true,false,350,200,349,199,-1,-1,1,true,-1.0
2,2,0.5,0.5,true,false,300,250,300,250,0,0,0,true,-1.0
2,2,0.5,0.5,true,false,250,350,248,348,-2,-2,2,true,-1.0
2,2,0.5,0.5,true,false,300,200,300,200,0,0,0,true,-1.0
2,2,0.5,0.5,false,true,300,350,299,349,-1,-1,1,true,123.126
2,2,0.5,0.5,false,true,300,300,798,898,498,598,2,true,-1.0
2,2,0.5,0.5,false,true,900,200,900,200,0,0,0,true,-1.0
2,2,0.5,0.5,false,true,250,250,798,348,548,98,2,true,-1.0
2,2,0.5,0.5,false,true,850,350,849,349,-1,-1,1,true,-1.0
2,2,0.5,0.5,false,true,300,300,798,898,498,598,2,true,-1.0
2,2,0.5,0.5,false,true,300,300,300,300,0,0,0,true,-1.0
2,2,0.5,0.5,false,true,300,300,300,300,0,0,0,false,-1.0
2,2,0.5,0.5,false,true,200,250,298,898,98,648,2,true,-1.0
2,2,0.5,0.5,false,true,300,900,798,948,498,48,2,true,-1.0
2,2,0.5,0.5,false,false,250,200,299,249,49,49,1,true,69.549
2,2,0.5,0.5,false,false,200,200,198,198,-2,-2,2,true,-1.0
2,2,0.5,0.5,false,false,300,300,348,798,48,498,2,true,-1.0
2,2,0.5,0.5,false,false,300,250,298,248,-2,-2,2,true,-1.0
2,2,0.5,0.5,false,false,300,300,797,397,497,97,3,true,-1.0
2,2,0.5,0.5,false,false,250,350,246,346,-4,-4,4,true,-1.0
2,2,0.5,0.5,false,false,250,850,249,849,-1,-1,1,true,-1.0
2,2,0.5,0.5,false,false,300,350,799,399,499,49,1,true,-1.0
2,2,0.5,0.5,false,false,200,200,200,200,0,0,0,true,-1.0
2,2,0.5,0.5,false,false,850,850,849,849,-1,-1,1,true,-1.0
0,0,0.5,0.5,false,false,200,200,298,898,98,698,2,false,0.15
0,0,0.5,0.5,false,false,200,850,197,847,-3,-3,3,true,-1.0
0,0,0.5,0.5,false,false,850,850,847,847,-3,-3,3,true,-1.0
0,0,0.5,0.5,false,false,200,200,197,197,-3,-3,3,true,-1.0
0,0,0.5,0.5,false,false,350,200,346,196,-4,-4,4,true,-1.0
0,0,0.5,0.5,false,false,300,250,297,247,-3,-3,3,true,-1.0
0,0,0.5,0.5,false,false,200,250,197,247,-3,-3,3,true,-1.0
0,0,0.5,0.5,false,false,300,250,298,248,-2,-2,2,true,-1.0
0,0,0.5,0.5,false,false,250,350,896,896,646,546,4,true,-1.0
0,0,0.5,0.5,false,false,300,300,348,798,48,498,2,true,-1.0
0,1,0.5,0.5,false,false,300,850,297,847,-3,-3,3,true,0.229
0,1,0.5,0.5,false,false,300,300,799,899,499,599,1,true,-1.0
0,1,0.5,0.5,false,false,200,300,348,798,148,498,2,true,-1.0
0,1,0.5,0.5,false,false,850,200,846,196,-4,-4,4,false,-1.0
0,1,0.5,0.5,false,false,250,850,246,846,-4,-4,4,true,-1.0
0,1,0.5,0.5,false,false,850,300,846,296,-4,-4,4,true,-1.0
0,1,0.5,0.5,false,false,200,300,298,898,98,598,2,true,-1.0
0,1,0.5,0.5,false,false,250,300,798,948,548,648,2,true,-1.0
0,1,0.5,0.5,false,false,300,350,797,397,497,47,3,true,-1.0
0,1,0.5,0.5,false,false,850,300,848,298,-2,-2,2,true,-1.0
0,2,0.5,0.5,false,true,300,200,799,899,499,699,1,true,318.194
0,2,0.5,0.5,false,true,200,250,248,848,48,598,2,true,-1.0
0,2,0.5,0.5,false,true,200,300,796,346,596,46,4,true,-1.0
0,2,0.5,0.5,false,true,850,250,846,246,-4,-4,4,true,-1.0
0,2,0.5,0.5,false,true,250,350,298,898,48,548,2,true,-1.0
0,2,0.5,0.5,false,true,850,200,846,196,-4,-4,4,false,-1.0
0,2,0.5,0.5,false,true,850,850,848,848,-2,-2,2,true,-1.0
0,2,0.5,0.5,false,true,350,200,346,196,-4,-4,4,false,-1.0
0,2,0.5,0.5,false,true,200,200,248,298,48,98,2,true,-1.0
0,2,0.5,0.5,false,true,250,200,249,199,-1,-1,1,true,-1.0
0,2,0.5,0.5,false,false,200,250,248,798,48,548,2,true,52.167
0,2,0.5,0.5,false,false,250,300,799,399,549,99,1,true,-1.0
0,2,0.5,0.5,false,false,250,850,799,899,549,49,1,true,-1.0
0,2,0.5,0.5,false,false,300,250,348,798,48,548,2,true,-1.0
0,2,0.5,0.5,false,false,200,850,199,849,-1,-1,1,true,-1.0
0,2,0.5,0.5,false,false,250,250,246,246,-4,-4,4,false,-1.0
0,2,0.5,0.5,false,false,300,200,898,848,598,648,2,true,-1.0
0,2,0.5,0.5,false,false,350,300,899,849,549,549,1,true,-1.0
0,2,0.5,0.5,false,false,300,300,296,296,-4,-4,4,true,-1.0
0,2,0.5,0.5,false,false,900,350,896,346,-4,-4,4,true,-1.0
1,0,0.5,0.5,false,false,200,350,898,898,698,548,2,true,0.283
1,0,0.5,0.5,false,false,300,300,898,798,598,498,2,true,-1.0
1,0,0.5,0.5,false,false,250,300,948,798,698,498,2,true,-1.0
1,0,0.5,0.5,false,false,850,200,850,200,0,0,0,true,-1.0
1,0,0.5,0.5,false,false,250,250,250,250,0,0,0,true,-1.0
1,0,0.5,0.5,false,false,300,250,295,245,-5,-5,5,true,-1.0
1,0,0.5,0.5,false,false,900,250,896,246,-4,-4,4,true,-1.0
1,0,0.5,0.5,false,false,300,850,799,899,499,49,1,true,-1.0
1,0,0.5,0.5,false,false,300,200,797,397,497,197,3,true,-1.0
1,0,0.5,0.5,false,false,300,300,296,296,-4,-4,4,true,-1.0
1,1,0.5,0.5,false,false,250,850,247,847,-3,-3,3,true,0.927
1,1,0.5,0.5,false,false,850,350,850,350,0,0,0,true,-1.0
1,1,0.5,0.5,false,false,250,200,250,200,0,0,0,false,-1.0
1,1,0.5,0.5,false,false,300,850,250,800,-50,-50,50,true,-1.0
1,1,0.5,0.5,false,false,250,850,297,897,47,47,3,true,-1.0
1,1,0.5,0.5,false,false,200,200,150,150,-50,-50,50,true,-1.0
1,1,0.5,0.5,false,false,300,200,250,150,-50,-50,50,true,-1.0
1,1,0.5,0.5,false,false,850,250,898,798,48,548,2,true,-1.0
1,1,0.5,0.5,false,false,350,300,346,296,-4,-4,4,true,-1.0
1,1,0.5,0.5,false,false,250,200,250,200,0,0,0,true,-1.0
1,2,0.5,0.5,false,true,300,350,298,348,-2,-2,2,true,642.822
1,2,0.5,0.5,false,true,900,850,899,849,-1,-1,1,true,-1.0
1,2,0.5,0.5,false,true,850,850,850,850,0,0,0,true,-1.0
1,2,0.5,0.5,false,true,250,850,798,898,548,48,2,true,-1.0
1,2,0.5,0.5,false,true,250,250,250,250,0,0,0,true,-1.0
1,2,0.5,0.5,false,true,300,300,848,848,548,548,2,true,-1.0
1,2,0.5,0.5,false,true,250,250,899,799,649,549,1,true,-1.0
1,2,0.5,0.5,false,true,300,350,799,949,499,599,1,true,-1.0
1,2,0.5,0.5,false,true,850,350,848,348,-2,-2,2,true,-1.0
1,2,0.5,0.5,false,true,200,300,199,299,-1,-1,1,true,-1.0
1,2,0.5,0.5,false,false,250,200,250,200,0,0,0,true,111.935
1,2,0.5,0.5,false,false,200,300,247,797,47,497,3,true,-1.0
1,2,0.5,0.5,false,false,850,250,838,238,-12,-12,12,true,-1.0
1,2,0.5,0.5,false,false,250,200,246,196,-4,-4,4,true,-1.0
1,2,0.5,0.5,false,false,200,200,200,200,0,0,0,true,-1.0
1,2,0.5,0.5,false,false,850,200,846,196,-4,-4,4,true,-1.0
1,2,0.5,0.5,false,false,200,200,198,198,-2,-2,2,true,-1.0
1,2,0.5,0.5,false,false,350,200,350,200,0,0,0,true,-1.0
1,2,0.5,0.5,false,false,300,250,849,349,549,99,1,true,-1.0
1,2,0.5,0.5,false,false,300,300,798,398,498,98,2,true,-1.0
2,0,0.5,0.5,true,false,850,200,850,200,0,0,0,true,489.898
2,0,0.5,0.5,true,false,350,200,397,297,47,97,3,true,-1.0
2,0,0.5,0.5,true,false,300,350,346,896,46,546,4,true,-1.0
2,0,0.5,0.5,true,false,300,300,300,300,0,0,0,true,-1.0
2,0,0.5,0.5,true,false,200,850,197,847,-3,-3,3,true,-1.0
2,0,0.5,0.5,true,false,900,850,900,850,0,0,0,true,-1.0
2,0,0.5,0.5,true,false,850,250,850,250,0,0,0,true,-1.0
2,0,0.5,0.5,true,false,300,250,297,247,-3,-3,3,true,-1.0
2,0,0.5,0.5,true,false,850,900,850,900,0,0,0,true,-1.0
2,0,0.5,0.5,true,false,850,300,850,300,0,0,0,true,-1.0
2,0,0.5,0.5,false,false,300,200,297,197,-3,-3,3,true,93.634
2,0,0.5,0.5,false,false,300,350,297,347,-3,-3,3,true,-1.0
2,0,0.5,0.5,false,false,300,250,347,297,47,47,3,true,-1.0
2,0,0.5,0.5,false,false,250,300,398,798,148,498,2,true,-1.0
2,0,0.5,0.5,false,false,250,300,247,297,-3,-3,3,true,-1.0
2,0,0.5,0.5,false,false,250,850,797,897,547,47,3,true,-1.0
2,0,0.5,0.5,false,false,200,250,797,297,597,47,3,true,-1.0
2,0,0.5,0.5,false,false,300,300,297,297,-3,-3,3,true,-1.0
2,0,0.5,0.5,false,false,250,200,797,297,547,97,3,false,-1.0
2,0,0.5,0.5,false,false,250,300,245,295,-5,-5,5,false,-1.0
2,1,0.5,0.5,true,false,200,300,246,346,46,46,4,true,655.961
2,1,0.5,0.5,true,false,250,300,348,798,98,498,2,true,-1.0
2,1,0.5,0.5,true,false,200,300,197,297,-3,-3,3,true,-1.0
2,1,0.5,0.5,true,false,250,250,247,247,-3,-3,3,true,-1.0
2,1,0.5,0.5,true,false,300,300,300,300,0,0,0,true,-1.0
2,1,0.5,0.5,true,false,300,300,297,297,-3,-3,3,true,-1.0
2,1,0.5,0.5,true,false,200,250,796,396,596,146,4,true,-1.0
2,1,0.5,0.5,true,false,300,350,849,899,549,549,1,true,-1.0
2,1,0.5,0.5,true,false,900,300,897,297,-3,-3,3,true,-1.0
2,1,0.5,0.5,true,false,250,850,247,847,-3,-3,3,true,-1.0
2,1,0.5,0.5,false,false,300,300,299,299,-1,-1,1,false,132.444
2,1,0.5,0.5,false,false,250,300,298,898,48,598,2,true,-1.0
2,1,0.5,0.5,false,false,250,300,247,297,-3,-3,3,true,-1.0
2,1,0.5,0.5,false,false,850,300,847,297,-3,-3,3,true,-1.0
2,1,0.5,0.5,false,false,250,250,848,298,598,48,2,true,-1.0
2,1,0.5,0.5,false,false,250,850,247,847,-3,-3,3,true,-1.0
2,1,0.5,0.5,false,false,350,250,896,346,546,96,4,true,-1.0
2,1,0.5,0.5,false,false,350,350,347,347,-3,-3,3,true,-1.0
2,1,0.5,0.5,false,false,300,300,798,348,498,48,2,true,-1.0
2,1,0.5,0.5,false,false,300,300,297,297,-3,-3,3,true,-1.0
2,2,0.5,0.5,true,true,200,300,200,300,0,0,0,true,452.587
2,2,0.5,0.5,true,true,250,850,798,898,548,48,2,true,-1.0
2,2,0.5,0.5,true,true,350,200,896,346,546,146,4,true,-1.0
2,2,0.5,0.5,true,true,350,300,349,299,-1,-1,1,true,-1.0
2,2,0.5,0.5,true,true,350,250,349,249,-1,-1,1,true,-1.0
2,2,0.5,0.5,true,true,300,850,799,899,499,49,1,true,-1.0
2,2,0.5,0.5,true,true,850,900,849,899,-1,-1,1,true,-1.0
2,2,0.5,0.5,true,true,850,200,899,249,49,49,1,true,-1.0
2,2,0.5,0.5,true,true,250,850,248,848,-2,-2,2,true,-1.0
2,2,0.5,0.5,true,true,200,350,200,350,0,0,0,true,-1.0
2,2,0.5,0.5,true,false,250,300,798,348,548,48,2,true,479.746
2,2,0.5,0.5,true,false,250,250,250,250,0,0,0,true,-1.0
2,2,0.5,0.5,true,false,350,300,350,300,0,0,0,true,-1.0
2,2,0.5,0.5,true,false,250,200,349,249,99,49,1,true,-1.0
2,2,0.5,0.5,true,false,250,300,248,298,-2,-2,2,true,-1.0
2,2,0.5,0.5,true,false,250,300,249,299,-1,-1,1,true,-1.0
2,2,0.5,0.5,true,false,250,850,249,849,-1,-1,1,true,-1.0
2,2,0.5,0.5,true,false,200,200,833,283,633,83,17,true,-1.0
2,2,0.5,0.5,true,false,300,200,398,798,98,598,2,true,-1.0
2,2,0.5,0.5,true,false,200,350,197,347,-3,-3,3,true,-1.0
2,2,0.5,0.5,false,true,200,250,249,799,49,549,1,true,173.425
2,2,0.5,0.5,false,true,200,200,248,948,48,748,2,true,-1.0
2,2,0.5,0.5,false,true,300,300,948,798,648,498,2,true,-1.0
2,2,0.5,0.5,false,true,300,350,799,949,499,599,1,true,-1.0
2,2,0.5,0.5,false,true,250,300,298,848,48,548,2,true,-1.0
2,2,0.5,0.5,false,true,200,350,248,398,48,48,2,true,-1.0
2,2,0.5,0.5,false,true,250,250,250,250,0,0,0,true,-1.0
2,2,0.5,0.5,false,true,350,850,349,849,-1,-1,1,true,-1.0
2,2,0.5,0.5,false,true,850,250,849,249,-1,-1,1,true,-1.0
2,2,0.5,0.5,false,true,200,900,198,898,-2,-2,2,true,-1.0
2,2,0.5,0.5,false,false,300,300,299,299,-1,-1,1,true,75.034
2,2,0.5,0.5,false,false,850,200,899,799,49,599,1,true,-1.0
2,2,0.5,0.5,false,false,200,300,298,348,98,48,2,true,-1.0
2,2,0.5,0.5,false,false,850,300,849,299,-1,-1,1,true,-1.0
2,2,0.5,0.5,false,false,200,200,797,297,597,97,3,true,-1.0
2,2,0.5,0.5,false,false,250,300,248,298,-2,-2,2,true,-1.0
2,2,0.5,0.5,false,false,250,250,299,299,49,49,1,true,-1.0
2,2,0.5,0.5,false,false,850,250,850,250,0,0,0,true,-1.0
2,2,0.5,0.5,false,false,250,300,799,899,549,599,1,true,-1.0
2,2,0.5,0.5,false,false,250,250,797,347,547,97,3,true,-1.0
