init_tom,resp_tom,init_lr,resp_lr,init_canLie,resp_canLie,init_initPoints,resp_respPoints,init_finalPoints,resp_finalPoints,init_gain,resp_gain,nr_offers,outcome_is_PE,passed_time
0,0,0.5,0.5,false,false,300,850,297,847,-3,-3,3,true,0.464
0,0,0.5,0.5,false,false,300,200,296,196,-4,-4,4,true,-1.0
0,0,0.5,0.5,false,false,250,200,247,197,-3,-3,3,true,-1.0
0,0,0.5,0.5,false,false,250,300,246,296,-4,-4,4,false,-1.0
0,0,0.5,0.5,false,false,300,900,297,897,-3,-3,3,true,-1.0
0,0,0.5,0.5,false,false,350,350,346,346,-4,-4,4,true,-1.0
0,0,0.5,0.5,false,false,250,850,247,847,-3,-3,3,true,-1.0
0,0,0.5,0.5,false,false,300,300,297,297,-3,-3,3,true,-1.0
0,0,0.5,0.5,false,false,200,350,196,346,-4,-4,4,true,-1.0
0,0,0.5,0.5,false,false,300,300,297,297,-3,-3,3,true,-1.0
0,1,0.5,0.5,false,false,850,300,848,298,-2,-2,2,true,0.624
0,1,0.5,0.5,false,false,900,300,898,298,-2,-2,2,true,-1.0
0,1,0.5,0.5,false,false,250,300,799,899,549,599,1,true,-1.0
0,1,0.5,0.5,false,false,300,850,296,846,-4,-4,4,true,-1.0
0,1,0.5,0.5,false,false,200,250,799,349,599,99,1,true,-1.0
0,1,0.5,0.5,false,false,350,300,346,296,-4,-4,4,true,-1.0
0,1,0.5,0.5,false,false,250,850,246,846,-4,-4,4,true,-1.0
0,1,0.5,0.5,false,false,250,350,298,898,48,548,2,true,-1.0
0,1,0.5,0.5,false,false,300,250,296,246,-4,-4,4,true,-1.0
0,1,0.5,0.5,false,false,300,200,296,196,-4,-4,4,true,-1.0
0,2,0.5,0.5,false,true,900,300,898,298,-2,-2,2,false,339.044
0,2,0.5,0.5,false,true,250,200,298,798,48,598,2,false,-1.0
0,2,0.5,0.5,false,true,300,850,296,846,-4,-4,4,true,-1.0
0,2,0.5,0.5,false,true,850,300,849,299,-1,-1,1,true,-1.0
0,2,0.5,0.5,false,true,300,300,296,296,-4,-4,4,true,-1.0
0,2,0.5,0.5,false,true,900,300,896,296,-4,-4,4,true,-1.0
0,2,0.5,0.5,false,true,250,850,247,847,-3,-3,3,true,-1.0
0,2,0.5,0.5,false,true,200,250,248,798,48,548,2,true,-1.0
0,2,0.5,0.5,false,true,350,850,349,849,-1,-1,1,true,-1.0
0,2,0.5,0.5,false,true,250,850,246,846,-4,-4,4,true,-1.0
0,2,0.5,0.5,false,false,300,350,899,899,599,549,1,true,81.085
0,2,0.5,0.5,false,false,900,300,896,296,-4,-4,4,true,-1.0
0,2,0.5,0.5,false,false,200,250,248,798,48,548,2,true,-1.0
0,2,0.5,0.5,false,false,350,850,346,846,-4,-4,4,true,-1.0
0,2,0.5,0.5,false,false,250,250,797,297,547,47,3,true,-1.0
0,2,0.5,0.5,false,false,200,850,196,846,-4,-4,4,true,-1.0
0,2,0.5,0.5,false,false,300,250,348,848,48,598,2,true,-1.0
0,2,0.5,0.5,false,false,850,200,898,798,48,598,2,true,-1.0
0,2,0.5,0.5,false,false,300,350,799,949,499,599,1,true,-1.0
0,2,0.5,0.5,false,false,300,300,797,897,497,597,3,true,-1.0
1,0,0.5,0.5,false,false,300,850,797,897,497,47,3,true,0.32
1,0,0.5,0.5,false,false,200,250,249,799,49,549,1,true,-1.0
1,0,0.5,0.5,false,false,850,250,846,246,-4,-4,4,true,-1.0
1,0,0.5,0.5,false,false,200,300,799,899,599,599,1,true,-1.0
1,0,0.5,0.5,false,false,300,850,297,847,-3,-3,3,true,-1.0
1,0,0.5,0.5,false,false,850,250,850,250,0,0,0,true,-1.0
1,0,0.5,0.5,false,false,300,250,349,799,49,549,1,true,-1.0
1,0,0.5,0.5,false,false,850,200,850,200,0,0,0,true,-1.0
1,0,0.5,0.5,false,false,300,300,300,300,0,0,0,true,-1.0
1,0,0.5,0.5,false,false,850,300,848,298,-2,-2,2,true,-1.0
1,1,0.5,0.5,false,false,250,850,200,800,-50,-50,50,false,1.277
1,1,0.5,0.5,false,false,200,350,150,300,-50,-50,50,false,-1.0
1,1,0.5,0.5,false,false,250,300,298,798,48,498,2,true,-1.0
1,1,0.5,0.5,false,false,250,200,799,349,549,149,1,true,-1.0
1,1,0.5,0.5,false,false,200,300,348,798,148,498,2,true,-1.0
1,1,0.5,0.5,false,false,200,350,150,300,-50,-50,50,false,-1.0
1,1,0.5,0.5,false,false,350,300,350,300,0,0,0,true,-1.0
1,1,0.5,0.5,false,false,850,850,800,800,-50,-50,50,true,-1.0
1,1,0.5,0.5,false,false,850,300,850,300,0,0,0,true,-1.0
1,1,0.5,0.5,false,false,850,300,800,250,-50,-50,50,true,-1.0
1,2,0.5,0.5,false,true,350,250,399,799,49,549,1,true,715.706
1,2,0.5,0.5,false,true,200,350,899,899,699,549,1,true,-1.0
1,2,0.5,0.5,false,true,200,350,299,399,99,49,1,true,-1.0
1,2,0.5,0.5,false,true,300,200,799,299,499,99,1,true,-1.0
1,2,0.5,0.5,false,true,250,300,200,250,-50,-50,50,false,-1.0
1,2,0.5,0.5,false,true,350,250,350,250,0,0,0,true,-1.0
1,2,0.5,0.5,false,true,200,850,199,849,-1,-1,1,true,-1.0
1,2,0.5,0.5,false,true,200,200,198,198,-2,-2,2,true,-1.0
1,2,0.5,0.5,false,true,300,200,300,200,0,0,0,true,-1.0
1,2,0.5,0.5,false,true,350,850,350,850,0,0,0,true,-1.0
1,2,0.5,0.5,false,false,300,250,399,799,99,549,1,true,127.11
1,2,0.5,0.5,false,false,300,250,349,299,49,49,1,true,-1.0
1,2,0.5,0.5,false,false,300,250,798,348,498,98,2,true,-1.0
1,2,0.5,0.5,false,false,350,300,398,798,48,498,2,true,-1.0
1,2,0.5,0.5,false,false,300,850,298,848,-2,-2,2,true,-1.0
1,2,0.5,0.5,false,false,300,200,898,898,598,698,2,true,-1.0
1,2,0.5,0.5,false,false,200,900,248,948,48,48,2,true,-1.0
1,2,0.5,0.5,false,false,250,250,246,246,-4,-4,4,true,-1.0
1,2,0.5,0.5,false,false,200,300,199,299,-1,-1,1,true,-1.0
1,2,0.5,0.5,false,false,850,250,899,799,49,549,1,true,-1.0
2,0,0.5,0.5,true,false,300,300,300,300,0,0,0,true,565.033
2,0,0.5,0.5,true,false,250,850,245,845,-5,-5,5,false,-1.0
2,0,0.5,0.5,true,false,300,300,296,296,-4,-4,4,true,-1.0
2,0,0.5,0.5,true,false,300,250,297,247,-3,-3,3,true,-1.0
2,0,0.5,0.5,true,false,300,250,797,297,497,47,3,false,-1.0
2,0,0.5,0.5,true,false,250,300,797,347,547,47,3,true,-1.0
2,0,0.5,0.5,true,false,250,300,249,799,-1,499,1,true,-1.0
2,0,0.5,0.5,true,false,850,250,850,250,0,0,0,true,-1.0
2,0,0.5,0.5,true,false,300,850,297,847,-3,-3,3,false,-1.0
2,0,0.5,0.5,true,false,350,300,399,799,49,499,1,true,-1.0
2,0,0.5,0.5,false,false,300,200,300,200,0,0,0,true,85.507
2,0,0.5,0.5,false,false,300,200,797,247,497,47,3,true,-1.0
2,0,0.5,0.5,false,false,250,250,245,245,-5,-5,5,false,-1.0
2,0,0.5,0.5,false,false,350,300,350,300,0,0,0,true,-1.0
2,0,0.5,0.5,false,false,350,200,897,297,547,97,3,true,-1.0
2,0,0.5,0.5,false,false,300,200,797,297,497,97,3,false,-1.0
2,0,0.5,0.5,false,false,300,300,297,297,-3,-3,3,true,-1.0
2,0,0.5,0.5,false,false,850,300,899,799,49,499,1,true,-1.0
2,0,0.5,0.5,false,false,200,200,200,200,0,0,0,true,-1.0
2,0,0.5,0.5,false,false,200,250,249,799,49,549,1,true,-1.0
2,1,0.5,0.5,true,false,350,350,347,347,-3,-3,3,true,630.037
2,1,0.5,0.5,true,false,200,300,197,297,-3,-3,3,true,-1.0
2,1,0.5,0.5,true,false,850,850,850,850,0,0,0,true,-1.0
2,1,0.5,0.5,true,false,200,250,798,348,598,98,2,true,-1.0
2,1,0.5,0.5,true,false,850,200,899,299,49,99,1,true,-1.0
2,1,0.5,0.5,true,false,850,300,847,297,-3,-3,3,true,-1.0
2,1,0.5,0.5,true,false,850,850,850,850,0,0,0,true,-1.0
2,1,0.5,0.5,true,false,250,250,797,297,547,47,3,false,-1.0
2,1,0.5,0.5,true,false,300,300,300,300,0,0,0,false,-1.0
2,1,0.5,0.5,true,false,300,300,297,297,-3,-3,3,true,-1.0
2,1,0.5,0.5,false,false,300,200,799,249,499,49,1,true,165.912
2,1,0.5,0.5,false,false,200,200,348,798,148,598,2,true,-1.0
2,1,0.5,0.5,false,false,250,900,247,897,-3,-3,3,true,-1.0
2,1,0.5,0.5,false,false,250,300,346,796,96,496,4,true,-1.0
2,1,0.5,0.5,false,false,300,200,845,245,545,45,5,true,-1.0
2,1,0.5,0.5,false,false,250,350,247,347,-3,-3,3,true,-1.0
2,1,0.5,0.5,false,false,300,850,297,847,-3,-3,3,true,-1.0
2,1,0.5,0.5,false,false,300,250,798,348,498,98,2,true,-1.0
2,1,0.5,0.5,false,false,200,250,326,776,126,526,24,true,-1.0
2,1,0.5,0.5,false,false,350,250,399,299,49,49,1,true,-1.0
2,2,0.5,0.5,true,true,850,250,849,249,-1,-1,1,true,738.333
2,2,0.5,0.5,true,true,200,300,199,299,-1,-1,1,true,-1.0
2,2,0.5,0.5,true,true,200,300,248,948,48,648,2,true,-1.0
2,2,0.5,0.5,true,true,850,350,849,349,-1,-1,1,true,-1.0
2,2,0.5,0.5,true,true,250,850,248,848,-2,-2,2,true,-1.0
2,2,0.5,0.5,true,true,300,350,299,349,-1,-1,1,true,-1.0
2,2,0.5,0.5,true,true,350,200,349,199,-1,-1,1,true,-1.0
2,2,0.5,0.5,true,true,850,300,849,299,-1,-1,1,true,-1.0
2,2,0.5,0.5,true,true,250,350,298,898,48,548,2,true,-1.0
2,2,0.5,0.5,true,true,350,300,346,296,-4,-4,4,true,-1.0
2,2,0.5,0.5,true,false,200,300,248,348,48,48,2,true,560.652
2,2,0.5,0.5,true,false,250,200,249,199,-1,-1,1,true,-1.0
2,2,0.5,0.5,true,false,300,850,299,849,-1,-1,1,true,-1.0
2,2,0.5,0.5,true,false,850,200,899,299,49,99,1,true,-1.0
2,2,0.5,0.5,true,false,200,850,199,849,-1,-1,1,true,-1.0
2,2,0.5,0.5,true,false,250,200,349,299,99,99,1,true,-1.0
2,2,0.5,0.5,true,false,250,200,249,199,-1,-1,1,false,-1.0
2,2,0.5,0.5,true,false,850,350,849,349,-1,-1,1,true,-1.0
2,2,0.5,0.5,true,false,200,350,798,398,598,48,2,true,-1.0
2,2,0.5,0.5,true,false,300,200,799,249,499,49,1,true,-1.0
2,2,0.5,0.5,false,true,200,900,199,899,-1,-1,1,true,150.562
2,2,0.5,0.5,false,true,200,300,948,798,748,498,2,true,-1.0
2,2,0.5,0.5,false,true,850,300,850,300,0,0,0,true,-1.0
2,2,0.5,0.5,false,true,300,250,799,299,499,49,1,true,-1.0
2,2,0.5,0.5,false,true,250,850,249,849,-1,-1,1,true,-1.0
2,2,0.5,0.5,false,true,250,300,348,848,98,548,2,true,-1.0
2,2,0.5,0.5,false,true,200,850,198,848,-2,-2,2,true,-1.0
2,2,0.5,0.5,false,true,200,250,849,849,649,599,1,true,-1.0
2,2,0.5,0.5,false,true,250,250,247,247,-3,-3,3,true,-1.0
2,2,0.5,0.5,false,true,850,300,898,798,48,498,2,true,-1.0
2,2,0.5,0.5,false,false,300,300,349,799,49,499,1,true,95.676
2,2,0.5,0.5,false,false,850,350,850,350,0,0,0,true,-1.0
2,2,0.5,0.5,false,false,350,200,897,297,547,97,3,true,-1.0
2,2,0.5,0.5,false,false,300,250,797,297,497,47,3,true,-1.0
2,2,0.5,0.5,false,false,850,250,847,297,-3,47,3,true,-1.0
2,2,0.5,0.5,false,false,250,200,299,249,49,49,1,true,-1.0
2,2,0.5,0.5,false,false,250,350,799,399,549,49,1,true,-1.0
2,2,0.5,0.5,false,false,300,200,349,299,49,99,1,true,-1.0
2,2,0.5,0.5,false,false,300,250,799,899,499,649,1,true,-1.0
2,2,0.5,0.5,false,false,900,350,897,347,-3,-3,3,true,-1.0
0,0,0.5,0.5,false,false,850,850,847,847,-3,-3,3,true,0.205
0,0,0.5,0.5,false,false,300,250,799,399,499,149,1,true,-1.0
0,0,0.5,0.5,false,false,200,350,197,347,-3,-3,3,true,-1.0
0,0,0.5,0.5,false,false,300,200,297,197,-3,-3,3,true,-1.0
0,0,0.5,0.5,false,false,900,250,898,248,-2,-2,2,true,-1.0
0,0,0.5,0.5,false,false,300,300,799,349,499,49,1,true,-1.0
0,0,0.5,0.5,false,false,850,250,847,247,-3,-3,3,true,-1.0
0,0,0.5,0.5,false,false,350,300,397,797,47,497,3,true,-1.0
0,0,0.5,0.5,false,false,250,300,297,347,47,47,3,true,-1.0
0,0,0.5,0.5,false,false,200,300,198,298,-2,-2,2,true,-1.0
0,1,0.5,0.5,false,false,200,300,298,348,98,48,2,true,0.311
0,1,0.5,0.5,false,false,200,200,199,199,-1,-1,1,true,-1.0
0,1,0.5,0.5,false,false,200,350,248,898,48,548,2,true,-1.0
0,1,0.5,0.5,false,false,350,850,347,847,-3,-3,3,true,-1.0
0,1,0.5,0.5,false,false,900,200,898,198,-2,-2,2,true,-1.0
0,1,0.5,0.5,false,false,300,300,348,798,48,498,2,true,-1.0
0,1,0.5,0.5,false,false,250,300,799,349,549,49,1,true,-1.0
0,1,0.5,0.5,false,false,250,900,246,896,-4,-4,4,true,-1.0
0,1,0.5,0.5,false,false,200,200,199,199,-1,-1,1,true,-1.0
0,1,0.5,0.5,false,false,200,200,198,198,-2,-2,2,true,-1.0
0,2,0.5,0.5,false,true,300,350,797,397,497,47,3,true,430.796
0,2,0.5,0.5,false,true,250,200,298,848,48,648,2,true,-1.0
0,2,0.5,0.5,false,true,350,300,346,296,-4,-4,4,true,-1.0
0,2,0.5,0.5,false,true,200,350,248,398,48,48,2,true,-1.0
0,2,0.5,0.5,false,true,300,250,348,798,48,548,2,true,-1.0
0,2,0.5,0.5,false,true,900,250,896,246,-4,-4,4,true,-1.0
0,2,0.5,0.5,false,true,850,250,848,248,-2,-2,2,true,-1.0
0,2,0.5,0.5,false,true,300,300,797,347,497,47,3,true,-1.0
0,2,0.5,0.5,false,true,300,250,348,298,48,48,2,true,-1.0
0,2,0.5,0.5,false,true,300,250,296,246,-4,-4,4,false,-1.0
0,2,0.5,0.5,false,false,250,200,296,296,46,96,4,true,68.825
0,2,0.5,0.5,false,false,300,350,296,346,-4,-4,4,true,-1.0
0,2,0.5,0.5,false,false,300,250,297,247,-3,-3,3,true,-1.0
0,2,0.5,0.5,false,false,850,250,848,248,-2,-2,2,true,-1.0
0,2,0.5,0.5,false,false,200,250,248,298,48,48,2,true,-1.0
0,2,0.5,0.5,false,false,300,300,296,296,-4,-4,4,true,-1.0
0,2,0.5,0.5,false,false,250,300,246,296,-4,-4,4,true,-1.0
0,2,0.5,0.5,false,false,300,900,797,947,497,47,3,true,-1.0
0,2,0.5,0.5,false,false,250,300,348,798,98,498,2,true,-1.0
0,2,0.5,0.5,false,false,300,300,299,299,-1,-1,1,true,-1.0
1,0,0.5,0.5,false,false,200,200,197,197,-3,-3,3,true,0.337
1,0,0.5,0.5,false,false,300,300,295,295,-5,-5,5,true,-1.0
1,0,0.5,0.5,false,false,350,250,399,799,49,549,1,true,-1.0
1,0,0.5,0.5,false,false,850,300,899,799,49,499,1,true,-1.0
1,0,0.5,0.5,false,false,200,250,797,897,597,647,3,true,-1.0
1,0,0.5,0.5,false,false,300,250,799,299,499,49,1,true,-1.0
1,0,0.5,0.5,false,false,300,350,295,345,-5,-5,5,true,-1.0
1,0,0.5,0.5,false,false,200,250,197,247,-3,-3,3,true,-1.0
1,0,0.5,0.5,false,false,300,300,849,849,549,549,1,true,-1.0
1,0,0.5,0.5,false,false,850,300,899,799,49,499,1,true,-1.0
1,1,0.5,0.5,false,false,300,250,250,200,-50,-50,50,true,1.191
1,1,0.5,0.5,false,false,300,300,899,799,599,499,1,true,-1.0
1,1,0.5,0.5,false,false,300,900,297,897,-3,-3,3,true,-1.0
1,1,0.5,0.5,false,false,900,350,897,347,-3,-3,3,true,-1.0
1,1,0.5,0.5,false,false,250,300,200,250,-50,-50,50,true,-1.0
1,1,0.5,0.5,false,false,850,200,899,249,49,49,1,true,-1.0
1,1,0.5,0.5,false,false,350,250,300,200,-50,-50,50,true,-1.0
1,1,0.5,0.5,false,false,250,300,899,799,649,499,1,true,-1.0
1,1,0.5,0.5,false,false,200,200,799,249,599,49,1,true,-1.0
1,1,0.5,0.5,false,false,250,200,250,200,0,0,0,true,-1.0
1,2,0.5,0.5,false,true,350,200,346,196,-4,-4,4,false,493.169
1,2,0.5,0.5,false,true,350,850,350,850,0,0,0,true,-1.0
1,2,0.5,0.5,false,true,300,350,298,348,-2,-2,2,true,-1.0
1,2,0.5,0.5,false,true,250,200,791,391,541,191,9,true,-1.0
1,2,0.5,0.5,false,true,850,350,850,350,0,0,0,true,-1.0
1,2,0.5,0.5,false,true,850,250,850,250,0,0,0,true,-1.0
1,2,0.5,0.5,false,true,350,900,348,898,-2,-2,2,true,-1.0
1,2,0.5,0.5,false,true,200,200,200,200,0,0,0,true,-1.0
1,2,0.5,0.5,false,true,300,250,348,798,48,548,2,true,-1.0
1,2,0.5,0.5,false,true,250,850,250,850,0,0,0,true,-1.0
1,2,0.5,0.5,false,false,250,300,799,899,549,599,1,true,98.368
1,2,0.5,0.5,false,false,200,300,198,298,-2,-2,2,true,-1.0
1,2,0.5,0.5,false,false,850,250,899,299,49,49,1,true,-1.0
1,2,0.5,0.5,false,false,250,300,250,300,0,0,0,true,-1.0
1,2,0.5,0.5,false,false,250,300,297,797,47,497,3,true,-1.0
1,2,0.5,0.5,false,false,850,200,882,282,32,82,18,true,-1.0
1,2,0.5,0.5,false,false,200,200,198,198,-2,-2,2,true,-1.0
1,2,0.5,0.5,false,false,850,850,849,849,-1,-1,1,true,-1.0
1,2,0.5,0.5,false,false,250,300,799,899,549,599,1,true,-1.0
1,2,0.5,0.5,false,false,300,850,300,850,0,0,0,true,-1.0
2,0,0.5,0.5,true,false,200,200,247,247,47,47,3,true,527.638
2,0,0.5,0.5,true,false,300,300,297,297,-3,-3,3,false,-1.0
2,0,0.5,0.5,true,false,300,200,348,898,48,698,2,true,-1.0
2,0,0.5,0.5,true,false,200,300,348,798,148,498,2,true,-1.0
2,0,0.5,0.5,true,false,850,250,845,245,-5,-5,5,true,-1.0
2,0,0.5,0.5,true,false,300,850,797,897,497,47,3,true,-1.0
2,0,0.5,0.5,true,false,300,300,297,297,-3,-3,3,true,-1.0
2,0,0.5,0.5,true,false,250,850,799,899,549,49,1,true,-1.0
2,0,0.5,0.5,true,false,300,200,300,200,0,0,0,true,-1.0
2,0,0.5,0.5,true,false,250,200,250,200,0,0,0,true,-1.0
2,0,0.5,0.5,false,false,200,300,298,798,98,498,2,true,87.608
2,0,0.5,0.5,false,false,300,300,295,295,-5,-5,5,true,-1.0
2,0,0.5,0.5,false,false,200,250,195,245,-5,-5,5,false,-1.0
2,0,0.5,0.5,false,false,250,850,245,845,-5,-5,5,true,-1.0
2,0,0.5,0.5,false,false,300,350,300,350,0,0,0,true,-1.0
2,0,0.5,0.5,false,false,250,300,247,297,-3,-3,3,true,-1.0
2,0,0.5,0.5,false,false,300,850,297,847,-3,-3,3,true,-1.0
2,0,0.5,0.5,false,false,300,350,297,347,-3,-3,3,false,-1.0
2,0,0.5,0.5,false,false,300,300,848,898,548,598,2,true,-1.0
2,0,0.5,0.5,false,false,300,300,297,297,-3,-3,3,true,-1.0
2,1,0.5,0.5,true,false,250,250,247,247,-3,-3,3,true,857.112
2,1,0.5,0.5,true,false,350,200,350,200,0,0,0,true,-1.0
2,1,0.5,0.5,true,false,850,300,847,297,-3,-3,3,true,-1.0
2,1,0.5,0.5,true,false,300,850,295,845,-5,-5,5,true,-1.0
2,1,0.5,0.5,true,false,850,200,899,799,49,599,1,true,-1.0
2,1,0.5,0.5,true,false,250,250,247,247,-3,-3,3,true,-1.0
2,1,0.5,0.5,true,false,250,300,848,898,598,598,2,true,-1.0
2,1,0.5,0.5,true,false,300,350,291,341,-9,-9,9,true,-1.0
2,1,0.5,0.5,true,false,900,200,900,200,0,0,0,true,-1.0
2,1,0.5,0.5,true,false,200,300,200,300,0,0,0,true,-1.0
2,1,0.5,0.5,false,false,300,850,297,847,-3,-3,3,true,125.019
2,1,0.5,0.5,false,false,900,200,900,200,0,0,0,true,-1.0
2,1,0.5,0.5,false,false,350,350,347,347,-3,-3,3,true,-1.0
2,1,0.5,0.5,false,false,300,850,299,849,-1,-1,1,true,-1.0
2,1,0.5,0.5,false,false,300,300,797,897,497,597,3,true,-1.0
2,1,0.5,0.5,false,false,850,250,899,799,49,549,1,true,-1.0
2,1,0.5,0.5,false,false,250,300,288,788,38,488,12,true,-1.0
2,1,0.5,0.5,false,false,900,200,900,200,0,0,0,true,-1.0
2,1,0.5,0.5,false,false,850,850,849,849,-1,-1,1,true,-1.0
2,1,0.5,0.5,false,false,200,250,234,784,34,534,16,true,-1.0
2,2,0.5,0.5,true,true,300,300,296,296,-4,-4,4,true,880.876
2,2,0.5,0.5,true,true,200,250,299,299,99,49,1,true,-1.0
2,2,0.5,0.5,true,true,850,200,850,200,0,0,0,true,-1.0
2,2,0.5,0.5,true,true,250,200,797,247,547,47,3,true,-1.0
2,2,0.5,0.5,true,true,250,850,249,849,-1,-1,1,true,-1.0
2,2,0.5,0.5,true,true,300,200,299,199,-1,-1,1,true,-1.0
2,2,0.5,0.5,true,true,850,200,899,249,49,49,1,true,-1.0
2,2,0.5,0.5,true,true,350,350,349,349,-1,-1,1,true,-1.0
2,2,0.5,0.5,true,true,850,850,849,849,-1,-1,1,true,-1.0
2,2,0.5,0.5,true,true,300,300,299,299,-1,-1,1,true,-1.0
2,2,0.5,0.5,true,false,300,300,300,300,0,0,0,true,570.024
2,2,0.5,0.5,true,false,300,300,300,300,0,0,0,true,-1.0
2,2,0.5,0.5,true,false,250,900,249,899,-1,-1,1,true,-1.0
2,2,0.5,0.5,true,false,350,850,349,849,-1,-1,1,true,-1.0
2,2,0.5,0.5,true,false,250,300,249,299,-1,-1,1,true,-1.0
2,2,0.5,0.5,true,false,350,250,899,849,549,599,1,true,-1.0
2,2,0.5,0.5,true,false,300,250,398,798,98,548,2,true,-1.0
2,2,0.5,0.5,true,false,250,200,299,249,49,49,1,true,-1.0
2,2,0.5,0.5,true,false,250,300,298,348,48,48,2,true,-1.0
2,2,0.5,0.5,true,false,200,300,199,299,-1,-1,1,true,-1.0
2,2,0.5,0.5,false,true,850,850,849,849,-1,-1,1,true,171.814
2,2,0.5,0.5,false,true,200,250,399,799,199,549,1,true,-1.0
2,2,0.5,0.5,false,true,250,250,348,798,98,548,2,true,-1.0
2,2,0.5,0.5,false,true,200,300,898,798,698,498,2,true,-1.0
2,2,0.5,0.5,false,true,250,200,296,296,46,96,4,false,-1.0
2,2,0.5,0.5,false,true,300,350,848,898,548,548,2,true,-1.0
2,2,0.5,0.5,false,true,200,300,248,798,48,498,2,true,-1.0
2,2,0.5,0.5,false,true,200,350,798,948,598,598,2,true,-1.0
2,2,0.5,0.5,false,true,850,300,850,300,0,0,0,true,-1.0
2,2,0.5,0.5,false,true,200,250,248,298,48,48,2,true,-1.0
2,2,0.5,0.5,false,false,200,250,295,295,95,45,5,true,106.033
2,2,0.5,0.5,false,false,850,350,849,349,-1,-1,1,true,-1.0
2,2,0.5,0.5,false,false,250,250,799,299,549,49,1,true,-1.0
2,2,0.5,0.5,false,false,250,300,948,798,698,498,2,true,-1.0
2,2,0.5,0.5,false,false,850,900,849,899,-1,-1,1,true,-1.0
2,2,0.5,0.5,false,false,300,200,300,200,0,0,0,true,-1.0
2,2,0.5,0.5,false,false,200,300,198,298,-2,-2,2,true,-1.0
2,2,0.5,0.5,false,false,250,850,249,849,-1,-1,1,true,-1.0
2,2,0.5,0.5,false,false,850,850,850,850,0,0,0,true,-1.0
2,2,0.5,0.5,false,false,250,200,899,799,649,599,1,true,-1.0
0,0,0.5,0.5,false,false,250,250,899,849,649,599,1,true,0.222
0,0,0.5,0.5,false,false,300,300,298,298,-2,-2,2,true,-1.0
0,0,0.5,0.5,false,false,200,300,248,798,48,498,2,true,-1.0
0,0,0.5,0.5,false,false,300,300,348,798,48,498,2,true,-1.0
0,0,0.5,0.5,false,false,250,200,246,196,-4,-4,4,false,-1.0
0,0,0.5,0.5,false,false,850,250,847,247,-3,-3,3,true,-1.0
0,0,0.5,0.5,false,false,300,200,348,798,48,598,2,true,-1.0
0,0,0.5,0.5,false,false,300,850,297,847,-3,-3,3,true,-1.0
0,0,0.5,0.5,false,false,850,300,896,796,46,496,4,true,-1.0
0,0,0.5,0.5,false,false,250,350,247,347,-3,-3,3,true,-1.0
0,1,0.5,0.5,false,false,300,250,797,297,497,47,3,true,0.313
0,1,0.5,0.5,false,false,350,300,398,798,48,498,2,true,-1.0
0,1,0.5,0.5,false,false,250,250,246,246,-4,-4,4,true,-1.0
0,1,0.5,0.5,false,false,300,250,296,246,-4,-4,4,false,-1.0
0,1,0.5,0.5,false,false,300,200,296,196,-4,-4,4,true,-1.0
0,1,0.5,0.5,false,false,200,300,248,898,48,598,2,true,-1.0
0,1,0.5,0.5,false,false,850,850,846,846,-4,-4,4,true,-1.0
0,1,0.5,0.5,false,false,850,300,846,296,-4,-4,4,true,-1.0
0,1,0.5,0.5,false,false,300,300,799,349,499,49,1,true,-1.0
0,1,0.5,0.5,false,false,850,850,848,848,-2,-2,2,true,-1.0
0,2,0.5,0.5,false,true,350,850,346,846,-4,-4,4,true,365.959
0,2,0.5,0.5,false,true,250,300,296,796,46,496,4,true,-1.0
0,2,0.5,0.5,false,true,900,250,896,246,-4,-4,4,false,-1.0
0,2,0.5,0.5,false,true,250,300,898,798,648,498,2,true,-1.0
0,2,0.5,0.5,false,true,300,350,299,349,-1,-1,1,true,-1.0
0,2,0.5,0.5,false,true,250,300,247,297,-3,-3,3,true,-1.0
0,2,0.5,0.5,false,true,200,900,199,899,-1,-1,1,true,-1.0
0,2,0.5,0.5,false,true,850,300,846,296,-4,-4,4,true,-1.0
0,2,0.5,0.5,false,true,250,300,849,849,599,549,1,true,-1.0
0,2,0.5,0.5,false,true,250,850,797,897,547,47,3,true,-1.0
0,2,0.5,0.5,false,false,200,250,246,346,46,96,4,false,69.005
0,2,0.5,0.5,false,false,250,300,897,347,647,47,3,true,-1.0
0,2,0.5,0.5,false,false,300,250,296,246,-4,-4,4,false,-1.0
0,2,0.5,0.5,false,false,200,250,248,348,48,98,2,true,-1.0
0,2,0.5,0.5,false,false,200,300,196,296,-4,-4,4,true,-1.0
0,2,0.5,0.5,false,false,300,850,299,849,-1,-1,1,true,-1.0
0,2,0.5,0.5,false,false,200,250,199,249,-1,-1,1,true,-1.0
0,2,0.5,0.5,false,false,250,300,346,896,96,596,4,true,-1.0
0,2,0.5,0.5,false,false,200,300,348,848,148,548,2,true,-1.0
0,2,0.5,0.5,false,false,250,200,246,196,-4,-4,4,true,-1.0
1,0,0.5,0.5,false,false,300,250,898,798,598,548,2,true,0.285
1,0,0.5,0.5,false,false,850,300,898,798,48,498,2,true,-1.0
1,0,0.5,0.5,false,false,850,350,850,350,0,0,0,true,-1.0
1,0,0.5,0.5,false,false,300,300,797,347,497,47,3,true,-1.0
1,0,0.5,0.5,false,false,300,300,797,347,497,47,3,true,-1.0
1,0,0.5,0.5,false,false,300,850,297,847,-3,-3,3,true,-1.0
1,0,0.5,0.5,false,false,300,300,297,297,-3,-3,3,true,-1.0
1,0,0.5,0.5,false,false,300,200,300,200,0,0,0,true,-1.0
1,0,0.5,0.5,false,false,250,300,799,349,549,49,1,true,-1.0
1,0,0.5,0.5,false,false,200,200,200,200,0,0,0,true,-1.0
1,1,0.5,0.5,false,false,250,300,799,899,549,599,1,true,1.123
1,1,0.5,0.5,false,false,900,300,850,250,-50,-50,50,true,-1.0
1,1,0.5,0.5,false,false,850,250,800,200,-50,-50,50,true,-1.0
1,1,0.5,0.5,false,false,300,350,300,350,0,0,0,true,-1.0
1,1,0.5,0.5,false,false,850,250,800,200,-50,-50,50,true,-1.0
1,1,0.5,0.5,false,false,300,200,398,798,98,598,2,true,-1.0
1,1,0.5,0.5,false,false,200,850,197,847,-3,-3,3,true,-1.0
1,1,0.5,0.5,false,false,300,350,250,300,-50,-50,50,true,-1.0
1,1,0.5,0.5,false,false,200,250,348,798,148,548,2,true,-1.0
1,1,0.5,0.5,false,false,900,350,899,349,-1,-1,1,true,-1.0
1,2,0.5,0.5,false,true,300,300,396,796,96,496,4,true,727.965
1,2,0.5,0.5,false,true,300,250,300,250,0,0,0,true,-1.0
1,2,0.5,0.5,false,true,300,300,300,300,0,0,0,true,-1.0
1,2,0.5,0.5,false,true,250,200,849,849,599,649,1,true,-1.0
1,2,0.5,0.5,false,true,300,300,298,298,-2,-2,2,true,-1.0
1,2,0.5,0.5,false,true,300,300,250,250,-50,-50,50,false,-1.0
1,2,0.5,0.5,false,true,350,300,398,798,48,498,2,true,-1.0
1,2,0.5,0.5,false,true,350,300,399,799,49,499,1,true,-1.0
1,2,0.5,0.5,false,true,250,250,250,250,0,0,0,true,-1.0
1,2,0.5,0.5,false,true,300,300,250,250,-50,-50,50,false,-1.0
1,2,0.5,0.5,false,false,850,850,850,850,0,0,0,true,133.207
1,2,0.5,0.5,false,false,300,350,791,391,491,41,9,true,-1.0
1,2,0.5,0.5,false,false,250,250,248,248,-2,-2,2,true,-1.0
1,2,0.5,0.5,false,false,250,250,250,250,0,0,0,true,-1.0
1,2,0.5,0.5,false,false,300,250,797,297,497,47,3,true,-1.0
1,2,0.5,0.5,false,false,250,350,799,399,549,49,1,true,-1.0
1,2,0.5,0.5,false,false,200,300,297,347,97,47,3,true,-1.0
1,2,0.5,0.5,false,false,850,250,850,250,0,0,0,true,-1.0
1,2,0.5,0.5,false,false,250,250,299,299,49,49,1,true,-1.0
1,2,0.5,0.5,false,false,300,350,298,348,-2,-2,2,true,-1.0
2,0,0.5,0.5,true,false,300,850,797,897,497,47,3,true,540.721
2,0,0.5,0.5,true,false,300,200,797,897,497,697,3,true,-1.0
2,0,0.5,0.5,true,false,300,300,295,295,-5,-5,5,true,-1.0
2,0,0.5,0.5,true,false,300,300,297,297,-3,-3,3,true,-1.0
2,0,0.5,0.5,true,false,200,300,197,297,-3,-3,3,true,-1.0
2,0,0.5,0.5,true,false,850,250,850,250,0,0,0,true,-1.0
2,0,0.5,0.5,true,false,200,850,197,847,-3,-3,3,true,-1.0
2,0,0.5,0.5,true,false,900,300,949,799,49,499,1,true,-1.0
2,0,0.5,0.5,true,false,250,300,898,798,648,498,2,true,-1.0
2,0,0.5,0.5,true,false,350,250,350,250,0,0,0,true,-1.0
2,0,0.5,0.5,false,false,250,250,849,299,599,49,1,true,95.743
2,0,0.5,0.5,false,false,250,300,250,300,0,0,0,true,-1.0
2,0,0.5,0.5,false,false,250,300,247,297,-3,-3,3,true,-1.0
2,0,0.5,0.5,false,false,850,300,898,798,48,498,2,true,-1.0
2,0,0.5,0.5,false,false,300,850,297,847,-3,-3,3,true,-1.0
2,0,0.5,0.5,false,false,200,300,797,897,597,597,3,true,-1.0
2,0,0.5,0.5,false,false,850,300,899,799,49,499,1,true,-1.0
2,0,0.5,0.5,false,false,250,300,247,297,-3,-3,3,true,-1.0
2,0,0.5,0.5,false,false,850,350,847,347,-3,-3,3,true,-1.0
2,0,0.5,0.5,false,false,300,300,799,799,499,499,1,true,-1.0
2,1,0.5,0.5,true,false,300,250,378,778,78,528,22,true,711.831
2,1,0.5,0.5,true,false,850,300,847,297,-3,-3,3,true,-1.0
2,1,0.5,0.5,true,false,850,850,849,849,-1,-1,1,true,-1.0
2,1,0.5,0.5,true,false,300,250,348,298,48,48,2,true,-1.0
2,1,0.5,0.5,true,false,200,250,799,949,599,699,1,true,-1.0
2,1,0.5,0.5,true,false,850,300,847,297,-3,-3,3,true,-1.0
2,1,0.5,0.5,true,false,300,350,798,398,498,48,2,true,-1.0
2,1,0.5,0.5,true,false,200,200,200,200,0,0,0,true,-1.0
2,1,0.5,0.5,true,false,200,200,200,200,0,0,0,true,-1.0
2,1,0.5,0.5,true,false,850,300,898,798,48,498,2,true,-1.0
2,1,0.5,0.5,false,false,200,300,150,250,-50,-50,50,false,140.571
2,1,0.5,0.5,false,false,250,250,247,247,-3,-3,3,true,-1.0
2,1,0.5,0.5,false,false,300,250,799,299,499,49,1,true,-1.0
2,1,0.5,0.5,false,false,350,300,347,297,-3,-3,3,true,-1.0
2,1,0.5,0.5,false,false,350,350,349,349,-1,-1,1,true,-1.0
2,1,0.5,0.5,false,false,300,350,297,347,-3,-3,3,true,-1.0
2,1,0.5,0.5,false,false,250,250,349,799,99,549,1,true,-1.0
2,1,0.5,0.5,false,false,300,200,297,197,-3,-3,3,true,-1.0
2,1,0.5,0.5,false,false,850,200,850,200,0,0,0,true,-1.0
2,1,0.5,0.5,false,false,300,850,798,898,498,48,2,true,-1.0
2,2,0.5,0.5,true,true,250,300,248,298,-2,-2,2,true,570.286
2,2,0.5,0.5,true,true,250,850,298,898,48,48,2,true,-1.0
2,2,0.5,0.5,true,true,300,200,300,200,0,0,0,false,-1.0
2,2,0.5,0.5,true,true,300,200,298,198,-2,-2,2,true,-1.0
2,2,0.5,0.5,true,true,250,300,250,300,0,0,0,true,-1.0
2,2,0.5,0.5,true,true,300,300,299,299,-1,-1,1,true,-1.0
2,2,0.5,0.5,true,true,250,300,796,346,546,46,4,true,-1.0
2,2,0.5,0.5,true,true,850,200,849,199,-1,-1,1,true,-1.0
2,2,0.5,0.5,true,true,200,200,199,199,-1,-1,1,true,-1.0
2,2,0.5,0.5,true,true,250,250,288,788,38,538,12,true,-1.0
2,2,0.5,0.5,true,false,300,850,299,849,-1,-1,1,true,344.228
2,2,0.5,0.5,true,false,300,250,847,297,547,47,3,true,-1.0
2,2,0.5,0.5,true,false,300,250,799,899,499,649,1,true,-1.0
2,2,0.5,0.5,true,false,250,250,249,249,-1,-1,1,true,-1.0
2,2,0.5,0.5,true,false,350,350,346,346,-4,-4,4,true,-1.0
2,2,0.5,0.5,true,false,850,250,848,248,-2,-2,2,true,-1.0
2,2,0.5,0.5,true,false,300,200,799,249,499,49,1,true,-1.0
2,2,0.5,0.5,true,false,850,850,850,850,0,0,0,true,-1.0
2,2,0.5,0.5,true,false,250,850,798,898,548,48,2,true,-1.0
2,2,0.5,0.5,true,false,900,250,900,250,0,0,0,true,-1.0
2,2,0.5,0.5,false,true,300,300,299,299,-1,-1,1,true,303.042
2,2,0.5,0.5,false,true,850,850,849,849,-1,-1,1,true,-1.0
2,2,0.5,0.5,false,true,250,250,249,249,-1,-1,1,true,-1.0
2,2,0.5,0.5,false,true,850,350,849,349,-1,-1,1,true,-1.0
2,2,0.5,0.5,false,true,300,300,348,848,48,548,2,true,-1.0
2,2,0.5,0.5,false,true,850,850,849,849,-1,-1,1,true,-1.0
2,2,0.5,0.5,false,true,350,850,350,850,0,0,0,true,-1.0
2,2,0.5,0.5,false,true,200,300,249,799,49,499,1,true,-1.0
2,2,0.5,0.5,false,true,350,250,398,298,48,48,2,true,-1.0
2,2,0.5,0.5,false,true,250,300,249,299,-1,-1,1,true,-1.0
2,2,0.5,0.5,false,false,300,850,298,848,-2,-2,2,true,107.02
2,2,0.5,0.5,false,false,300,200,300,200,0,0,0,true,-1.0
2,2,0.5,0.5,false,false,300,900,299,899,-1,-1,1,true,-1.0
2,2,0.5,0.5,false,false,300,250,799,899,499,649,1,true,-1.0
2,2,0.5,0.5,false,false,200,350,248,898,48,548,2,true,-1.0
2,2,0.5,0.5,false,false,300,200,898,848,598,648,2,true,-1.0
2,2,0.5,0.5,false,false,250,300,247,297,-3,-3,3,true,-1.0
2,2,0.5,0.5,false,false,850,200,899,249,49,49,1,true,-1.0
2,2,0.5,0.5,false,false,300,300,797,897,497,597,3,true,-1.0
2,2,0.5,0.5,false,false,850,250,850,250,0,0,0,true,-1.0
0,0,0.5,0.5,false,false,350,300,347,297,-3,-3,3,true,0.18
0,0,0.5,0.5,false,false,300,350,797,397,497,47,3,true,-1.0
0,0,0.5,0.5,false,false,300,300,799,899,499,599,1,true,-1.0
0,0,0.5,0.5,false,false,250,300,296,796,46,496,4,true,-1.0
0,0,0.5,0.5,false,false,300,300,297,297,-3,-3,3,true,-1.0
0,0,0.5,0.5,false,false,300,350,296,346,-4,-4,4,true,-1.0
0,0,0.5,0.5,false,false,250,850,247,847,-3,-3,3,true,-1.0
0,0,0.5,0.5,false,false,300,300,296,296,-4,-4,4,true,-1.0
0,0,0.5,0.5,false,false,250,300,247,297,-3,-3,3,true,-1.0
0,0,0.5,0.5,false,false,200,300,246,796,46,496,4,true,-1.0
0,1,0.5,0.5,false,false,250,250,246,246,-4,-4,4,true,0.288
0,1,0.5,0.5,false,false,250,300,799,949,549,649,1,true,-1.0
0,1,0.5,0.5,false,false,350,200,346,196,-4,-4,4,true,-1.0
0,1,0.5,0.5,false,false,200,250,198,248,-2,-2,2,true,-1.0
0,1,0.5,0.5,false,false,350,250,348,248,-2,-2,2,true,-1.0
0,1,0.5,0.5,false,false,300,850,797,897,497,47,3,true,-1.0
0,1,0.5,0.5,false,false,200,900,196,896,-4,-4,4,true,-1.0
0,1,0.5,0.5,false,false,300,250,799,899,499,649,1,true,-1.0
0,1,0.5,0.5,false,false,850,300,848,298,-2,-2,2,true,-1.0
0,1,0.5,0.5,false,false,250,350,246,346,-4,-4,4,true,-1.0
0,2,0.5,0.5,false,true,200,200,199,199,-1,-1,1,true,330.127
0,2,0.5,0.5,false,true,300,300,296,296,-4,-4,4,true,-1.0
0,2,0.5,0.5,false,true,850,250,846,246,-4,-4,4,true,-1.0
0,2,0.5,0.5,false,true,250,300,298,798,48,498,2,true,-1.0
0,2,0.5,0.5,false,true,250,250,249,249,-1,-1,1,true,-1.0
0,2,0.5,0.5,false,true,850,250,846,246,-4,-4,4,true,-1.0
0,2,0.5,0.5,false,true,300,300,297,297,-3,-3,3,true,-1.0
0,2,0.5,0.5,false,true,250,200,248,198,-2,-2,2,true,-1.0
0,2,0.5,0.5,false,true,300,200,298,198,-2,-2,2,true,-1.0
0,2,0.5,0.5,false,true,850,850,849,849,-1,-1,1,true,-1.0
0,2,0.5,0.5,false,false,850,200,846,196,-4,-4,4,true,77.758
0,2,0.5,0.5,false,false,850,250,848,248,-2,-2,2,true,-1.0
0,2,0.5,0.5,false,false,350,300,349,299,-1,-1,1,true,-1.0
0,2,0.5,0.5,false,false,300,850,299,849,-1,-1,1,true,-1.0
0,2,0.5,0.5,false,false,300,350,346,896,46,546,4,true,-1.0
0,2,0.5,0.5,false,false,300,350,297,347,-3,-3,3,true,-1.0
0,2,0.5,0.5,false,false,250,200,247,197,-3,-3,3,true,-1.0
0,2,0.5,0.5,false,false,300,200,296,196,-4,-4,4,true,-1.0
0,2,0.5,0.5,false,false,300,250,296,246,-4,-4,4,true,-1.0
0,2,0.5,0.5,false,false,350,350,346,346,-4,-4,4,true,-1.0
1,0,0.5,0.5,false,false,900,200,900,200,0,0,0,false,0.323
1,0,0.5,0.5,false,false,200,850,249,899,49,49,1,true,-1.0
1,0,0.5,0.5,false,false,200,300,197,297,-3,-3,3,true,-1.0
1,0,0.5,0.5,false,false,300,300,297,297,-3,-3,3,true,-1.0
1,0,0.5,0.5,false,false,350,300,346,296,-4,-4,4,true,-1.0
1,0,0.5,0.5,false,false,300,300,799,799,499,499,1,true,-1.0
1,0,0.5,0.5,false,false,300,350,300,350,0,0,0,true,-1.0
1,0,0.5,0.5,false,false,350,200,397,247,47,47,3,true,-1.0
1,0,0.5,0.5,false,false,300,200,847,297,547,97,3,true,-1.0
1,0,0.5,0.5,false,false,200,850,197,847,-3,-3,3,true,-1.0
1,1,0.5,0.5,false,false,250,200,299,349,49,149,1,true,1.529
1,1,0.5,0.5,false,false,300,200,796,796,496,596,4,true,-1.0
1,1,0.5,0.5,false,false,300,300,348,798,48,498,2,true,-1.0
1,1,0.5,0.5,false,false,250,850,250,850,0,0,0,true,-1.0
1,1,0.5,0.5,false,false,250,200,250,200,0,0,0,true,-1.0
1,1,0.5,0.5,false,false,900,300,900,300,0,0,0,true,-1.0
1,1,0.5,0.5,false,false,300,200,250,150,-50,-50,50,true,-1.0
1,1,0.5,0.5,false,false,250,200,248,198,-2,-2,2,true,-1.0
1,1,0.5,0.5,false,false,350,300,300,250,-50,-50,50,true,-1.0
1,1,0.5,0.5,false,false,200,300,150,250,-50,-50,50,true,-1.0
1,2,0.5,0.5,false,true,300,850,298,848,-2,-2,2,true,532.798
1,2,0.5,0.5,false,true,200,850,198,848,-2,-2,2,true,-1.0
1,2,0.5,0.5,false,true,900,200,900,200,0,0,0,true,-1.0
1,2,0.5,0.5,false,true,850,200,850,200,0,0,0,true,-1.0
1,2,0.5,0.5,false,true,850,250,850,250,0,0,0,true,-1.0
1,2,0.5,0.5,false,true,200,250,198,248,-2,-2,2,true,-1.0
1,2,0.5,0.5,false,true,900,850,898,848,-2,-2,2,true,-1.0
1,2,0.5,0.5,false,true,250,350,298,398,48,48,2,true,-1.0
1,2,0.5,0.5,false,true,200,850,199,849,-1,-1,1,true,-1.0
1,2,0.5,0.5,false,true,350,300,349,299,-1,-1,1,true,-1.0
1,2,0.5,0.5,false,false,300,200,300,200,0,0,0,true,69.26
1,2,0.5,0.5,false,false,850,250,899,799,49,549,1,true,-1.0
1,2,0.5,0.5,false,false,300,350,300,350,0,0,0,true,-1.0
1,2,0.5,0.5,false,false,350,350,348,348,-2,-2,2,true,-1.0
1,2,0.5,0.5,false,false,300,250,896,796,596,546,4,true,-1.0
1,2,0.5,0.5,false,false,200,200,198,198,-2,-2,2,true,-1.0
1,2,0.5,0.5,false,false,250,300,797,947,547,647,3,true,-1.0
1,2,0.5,0.5,false,false,200,850,797,897,597,47,3,true,-1.0
1,2,0.5,0.5,false,false,300,250,298,248,-2,-2,2,true,-1.0
1,2,0.5,0.5,false,false,200,300,198,298,-2,-2,2,true,-1.0
2,0,0.5,0.5,true,false,300,300,296,296,-4,-4,4,true,601.35
2,0,0.5,0.5,true,false,300,300,348,848,48,548,2,true,-1.0
2,0,0.5,0.5,true,false,300,250,348,898,48,648,2,true,-1.0
2,0,0.5,0.5,true,false,250,300,797,397,547,97,3,true,-1.0
2,0,0.5,0.5,true,false,250,200,250,200,0,0,0,true,-1.0
2,0,0.5,0.5,true,false,250,850,247,847,-3,-3,3,true,-1.0
2,0,0.5,0.5,true,false,300,200,799,299,499,99,1,true,-1.0
2,0,0.5,0.5,true,false,300,850,297,847,-3,-3,3,true,-1.0
2,0,0.5,0.5,true,false,300,300,295,295,-5,-5,5,true,-1.0
2,0,0.5,0.5,true,false,350,200,897,247,547,47,3,false,-1.0
2,0,0.5,0.5,false,false,300,350,897,897,597,547,3,true,104.744
2,0,0.5,0.5,false,false,250,350,247,347,-3,-3,3,true,-1.0
2,0,0.5,0.5,false,false,200,250,197,247,-3,-3,3,true,-1.0
2,0,0.5,0.5,false,false,250,250,847,347,597,97,3,false,-1.0
2,0,0.5,0.5,false,false,200,300,248,798,48,498,2,true,-1.0
2,0,0.5,0.5,false,false,200,300,248,798,48,498,2,true,-1.0
2,0,0.5,0.5,false,false,300,850,297,847,-3,-3,3,true,-1.0
2,0,0.5,0.5,false,false,350,200,345,195,-5,-5,5,true,-1.0
2,0,0.5,0.5,false,false,200,900,197,897,-3,-3,3,true,-1.0
2,0,0.5,0.5,false,false,250,300,297,347,47,47,3,true,-1.0
2,1,0.5,0.5,true,false,350,350,347,347,-3,-3,3,true,1005.814
2,1,0.5,0.5,true,false,250,250,250,250,0,0,0,true,-1.0
2,1,0.5,0.5,true,false,200,300,795,345,595,45,5,true,-1.0
2,1,0.5,0.5,true,false,200,850,200,850,0,0,0,true,-1.0
2,1,0.5,0.5,true,false,300,200,349,299,49,99,1,true,-1.0
2,1,0.5,0.5,true,false,250,200,299,249,49,49,1,true,-1.0
2,1,0.5,0.5,true,false,200,200,197,197,-3,-3,3,true,-1.0
2,1,0.5,0.5,true,false,200,300,799,949,599,649,1,true,-1.0
2,1,0.5,0.5,true,false,300,250,898,298,598,48,2,true,-1.0
2,1,0.5,0.5,true,false,850,200,898,298,48,98,2,true,-1.0
2,1,0.5,0.5,false,false,850,350,850,350,0,0,0,true,174.689
2,1,0.5,0.5,false,false,250,350,249,349,-1,-1,1,false,-1.0
2,1,0.5,0.5,false,false,250,850,249,849,-1,-1,1,true,-1.0
2,1,0.5,0.5,false,false,300,200,349,299,49,99,1,true,-1.0
2,1,0.5,0.5,false,false,250,300,347,347,97,47,3,true,-1.0
2,1,0.5,0.5,false,false,250,850,249,849,-1,-1,1,true,-1.0
2,1,0.5,0.5,false,false,300,350,848,898,548,548,2,true,-1.0
2,1,0.5,0.5,false,false,850,300,850,300,0,0,0,true,-1.0
2,1,0.5,0.5,false,false,300,300,297,297,-3,-3,3,true,-1.0
2,1,0.5,0.5,false,false,200,350,899,899,699,549,1,true,-1.0
2,2,0.5,0.5,true,true,200,300,199,299,-1,-1,1,true,691.429
2,2,0.5,0.5,true,true,350,300,350,300,0,0,0,true,-1.0
2,2,0.5,0.5,true,true,250,250,799,299,549,49,1,true,-1.0
2,2,0.5,0.5,true,true,200,850,200,850,0,0,0,true,-1.0
2,2,0.5,0.5,true,true,250,300,298,848,48,548,2,true,-1.0
2,2,0.5,0.5,true,true,200,900,198,898,-2,-2,2,true,-1.0
2,2,0.5,0.5,true,true,300,300,948,798,648,498,2,true,-1.0
2,2,0.5,0.5,true,true,350,900,349,899,-1,-1,1,true,-1.0
2,2,0.5,0.5,true,true,250,300,787,337,537,37,13,true,-1.0
2,2,0.5,0.5,true,true,900,200,948,248,48,48,2,true,-1.0
2,2,0.5,0.5,true,false,300,250,300,250,0,0,0,true,327.119
2,2,0.5,0.5,true,false,200,850,199,849,-1,-1,1,true,-1.0
2,2,0.5,0.5,true,false,350,250,398,798,48,548,2,true,-1.0
2,2,0.5,0.5,true,false,850,200,850,200,0,0,0,true,-1.0
2,2,0.5,0.5,true,false,200,350,199,349,-1,-1,1,false,-1.0
2,2,0.5,0.5,true,false,850,300,898,798,48,498,2,true,-1.0
2,2,0.5,0.5,true,false,250,300,249,299,-1,-1,1,true,-1.0
2,2,0.5,0.5,true,false,250,300,249,299,-1,-1,1,true,-1.0
2,2,0.5,0.5,true,false,850,300,850,300,0,0,0,true,-1.0
2,2,0.5,0.5,true,false,850,850,850,850,0,0,0,true,-1.0
2,2,0.5,0.5,false,true,250,200,297,297,47,97,3,false,140.757
2,2,0.5,0.5,false,true,300,300,348,898,48,598,2,true,-1.0
2,2,0.5,0.5,false,true,300,300,348,798,48,498,2,true,-1.0
2,2,0.5,0.5,false,true,300,200,348,298,48,98,2,true,-1.0
2,2,0.5,0.5,false,true,200,300,198,298,-2,-2,2,true,-1.0
2,2,0.5,0.5,false,true,850,900,849,899,-1,-1,1,true,-1.0
2,2,0.5,0.5,false,true,200,200,798,348,598,148,2,true,-1.0
2,2,0.5,0.5,false,true,300,200,797,247,497,47,3,true,-1.0
2,2,0.5,0.5,false,true,850,250,850,250,0,0,0,true,-1.0
2,2,0.5,0.5,false,true,850,300,849,299,-1,-1,1,true,-1.0
2,2,0.5,0.5,false,false,900,250,948,798,48,548,2,true,91.311
2,2,0.5,0.5,false,false,300,300,898,798,598,498,2,true,-1.0
2,2,0.5,0.5,false,false,300,300,299,299,-1,-1,1,true,-1.0
2,2,0.5,0.5,false,false,850,200,850,200,0,0,0,true,-1.0
2,2,0.5,0.5,false,false,350,250,349,249,-1,-1,1,true,-1.0
2,2,0.5,0.5,false,false,200,250,798,898,598,648,2,true,-1.0
2,2,0.5,0.5,false,false,200,350,199,349,-1,-1,1,true,-1.0
2,2,0.5,0.5,false,false,200,350,248,898,48,548,2,true,-1.0
2,2,0.5,0.5,false,false,850,300,849,299,-1,-1,1,true,-1.0
2,2,0.5,0.5,false,false,850,250,899,799,49,549,1,true,-1.0
0,0,0.5,0.5,false,false,250,850,247,847,-3,-3,3,true,0.178
0,0,0.5,0.5,false,false,900,200,898,198,-2,-2,2,true,-1.0
0,0,0.5,0.5,false,false,250,250,797,397,547,147,3,true,-1.0
0,0,0.5,0.5,false,false,300,250,799,899,499,649,1,true,-1.0
0,0,0.5,0.5,false,false,250,850,247,847,-3,-3,3,true,-1.0
0,0,0.5,0.5,false,false,300,300,297,297,-3,-3,3,true,-1.0
0,0,0.5,0.5,false,false,850,250,848,248,-2,-2,2,false,-1.0
0,0,0.5,0.5,false,false,300,200,297,197,-3,-3,3,true,-1.0
0,0,0.5,0.5,false,false,350,300,897,347,547,47,3,true,-1.0
0,0,0.5,0.5,false,false,200,300,197,297,-3,-3,3,false,-1.0
0,1,0.5,0.5,false,false,300,250,296,246,-4,-4,4,true,0.277
0,1,0.5,0.5,false,false,300,300,797,347,497,47,3,true,-1.0
0,1,0.5,0.5,false,false,350,200,346,196,-4,-4,4,true,-1.0
0,1,0.5,0.5,false,false,300,300,799,399,499,99,1,true,-1.0
0,1,0.5,0.5,false,false,850,200,846,196,-4,-4,4,true,-1.0
0,1,0.5,0.5,false,false,250,300,246,296,-4,-4,4,true,-1.0
0,1,0.5,0.5,false,false,850,200,898,248,48,48,2,true,-1.0
0,1,0.5,0.5,false,false,300,900,296,896,-4,-4,4,true,-1.0
0,1,0.5,0.5,false,false,850,300,846,296,-4,-4,4,true,-1.0
0,1,0.5,0.5,false,false,300,300,296,296,-4,-4,4,true,-1.0
0,2,0.5,0.5,false,true,300,300,297,297,-3,-3,3,true,384.638
0,2,0.5,0.5,false,true,300,200,347,297,47,97,3,true,-1.0
0,2,0.5,0.5,false,true,250,850,247,847,-3,-3,3,true,-1.0
0,2,0.5,0.5,false,true,250,850,249,849,-1,-1,1,true,-1.0
0,2,0.5,0.5,false,true,350,850,346,846,-4,-4,4,true,-1.0
0,2,0.5,0.5,false,true,300,250,799,299,499,49,1,true,-1.0
0,2,0.5,0.5,false,true,250,300,798,898,548,598,2,true,-1.0
0,2,0.5,0.5,false,true,850,250,846,246,-4,-4,4,true,-1.0
0,2,0.5,0.5,false,true,250,350,298,898,48,548,2,true,-1.0
0,2,0.5,0.5,false,true,250,850,247,847,-3,-3,3,true,-1.0
0,2,0.5,0.5,false,false,300,200,348,898,48,698,2,true,74.244
0,2,0.5,0.5,false,false,200,850,199,849,-1,-1,1,true,-1.0
0,2,0.5,0.5,false,false,200,300,248,798,48,498,2,true,-1.0
0,2,0.5,0.5,false,false,250,300,249,299,-1,-1,1,true,-1.0
0,2,0.5,0.5,false,false,350,200,898,898,548,698,2,true,-1.0
0,2,0.5,0.5,false,false,200,200,196,196,-4,-4,4,true,-1.0
0,2,0.5,0.5,false,false,350,300,347,297,-3,-3,3,true,-1.0
0,2,0.5,0.5,false,false,300,850,296,846,-4,-4,4,true,-1.0
0,2,0.5,0.5,false,false,300,300,398,798,98,498,2,true,-1.0
0,2,0.5,0.5,false,false,300,350,297,347,-3,-3,3,true,-1.0
1,0,0.5,0.5,false,false,850,300,899,799,49,499,1,true,0.298
1,0,0.5,0.5,false,false,300,350,797,397,497,47,3,true,-1.0
1,0,0.5,0.5,false,false,300,850,297,847,-3,-3,3,true,-1.0
1,0,0.5,0.5,false,false,200,200,197,197,-3,-3,3,true,-1.0
1,0,0.5,0.5,false,false,350,250,897,297,547,47,3,true,-1.0
1,0,0.5,0.5,false,false,300,300,297,297,-3,-3,3,true,-1.0
1,0,0.5,0.5,false,false,300,300,297,297,-3,-3,3,true,-1.0
1,0,0.5,0.5,false,false,200,350,195,345,-5,-5,5,true,-1.0
1,0,0.5,0.5,false,false,300,850,297,847,-3,-3,3,true,-1.0
1,0,0.5,0.5,false,false,350,250,399,799,49,549,1,true,-1.0
1,1,0.5,0.5,false,false,300,200,799,899,499,699,1,true,1.621
1,1,0.5,0.5,false,false,200,300,897,797,697,497,3,true,-1.0
1,1,0.5,0.5,false,false,250,250,797,297,547,47,3,true,-1.0
1,1,0.5,0.5,false,false,850,350,800,300,-50,-50,50,true,-1.0
1,1,0.5,0.5,false,false,250,200,200,150,-50,-50,50,true,-1.0
1,1,0.5,0.5,false,false,350,250,350,250,0,0,0,true,-1.0
1,1,0.5,0.5,false,false,200,200,200,200,0,0,0,true,-1.0
1,1,0.5,0.5,false,false,350,300,398,798,48,498,2,true,-1.0
1,1,0.5,0.5,false,false,250,250,200,200,-50,-50,50,false,-1.0
1,1,0.5,0.5,false,false,200,850,197,847,-3,-3,3,true,-1.0
1,2,0.5,0.5,false,true,200,900,199,899,-1,-1,1,true,338.079
1,2,0.5,0.5,false,true,300,250,298,248,-2,-2,2,true,-1.0
1,2,0.5,0.5,false,true,900,200,900,200,0,0,0,true,-1.0
1,2,0.5,0.5,false,true,250,200,299,249,49,49,1,true,-1.0
1,2,0.5,0.5,false,true,850,250,848,248,-2,-2,2,true,-1.0
1,2,0.5,0.5,false,true,250,850,297,897,47,47,3,true,-1.0
1,2,0.5,0.5,false,true,250,250,249,249,-1,-1,1,true,-1.0
1,2,0.5,0.5,false,true,850,300,848,298,-2,-2,2,true,-1.0
1,2,0.5,0.5,false,true,300,850,298,848,-2,-2,2,true,-1.0
1,2,0.5,0.5,false,true,200,350,198,348,-2,-2,2,true,-1.0
1,2,0.5,0.5,false,false,200,300,199,299,-1,-1,1,true,112.593
1,2,0.5,0.5,false,false,850,300,848,298,-2,-2,2,true,-1.0
1,2,0.5,0.5,false,false,350,200,350,200,0,0,0,true,-1.0
1,2,0.5,0.5,false,false,300,300,799,899,499,599,1,true,-1.0
1,2,0.5,0.5,false,false,250,200,899,249,649,49,1,true,-1.0
1,2,0.5,0.5,false,false,350,900,350,900,0,0,0,true,-1.0
1,2,0.5,0.5,false,false,200,300,196,296,-4,-4,4,true,-1.0
1,2,0.5,0.5,false,false,300,250,348,798,48,548,2,true,-1.0
1,2,0.5,0.5,false,false,300,250,799,349,499,99,1,true,-1.0
1,2,0.5,0.5,false,false,300,350,849,899,549,549,1,true,-1.0
2,0,0.5,0.5,true,false,200,250,197,247,-3,-3,3,true,666.883
2,0,0.5,0.5,true,false,200,350,197,347,-3,-3,3,true,-1.0
2,0,0.5,0.5,true,false,300,350,797,397,497,47,3,true,-1.0
2,0,0.5,0.5,true,false,250,850,247,847,-3,-3,3,true,-1.0
2,0,0.5,0.5,true,false,250,300,296,796,46,496,4,true,-1.0
2,0,0.5,0.5,true,false,200,900,197,897,-3,-3,3,false,-1.0
2,0,0.5,0.5,true,false,200,850,197,847,-3,-3,3,true,-1.0
2,0,0.5,0.5,true,false,300,300,300,300,0,0,0,true,-1.0
2,0,0.5,0.5,true,false,300,300,300,300,0,0,0,true,-1.0
2,0,0.5,0.5,true,false,300,300,797,347,497,47,3,true,-1.0
2,0,0.5,0.5,false,false,300,300,297,297,-3,-3,3,true,88.723
2,0,0.5,0.5,false,false,200,300,195,295,-5,-5,5,true,-1.0
2,0,0.5,0.5,false,false,250,300,245,295,-5,-5,5,true,-1.0
2,0,0.5,0.5,false,false,300,250,297,247,-3,-3,3,false,-1.0
2,0,0.5,0.5,false,false,250,850,247,847,-3,-3,3,true,-1.0
2,0,0.5,0.5,false,false,850,250,847,247,-3,-3,3,true,-1.0
2,0,0.5,0.5,false,false,300,200,300,200,0,0,0,true,-1.0
2,0,0.5,0.5,false,false,900,200,895,195,-5,-5,5,true,-1.0
2,0,0.5,0.5,false,false,850,250,850,250,0,0,0,true,-1.0
2,0,0.5,0.5,false,false,850,850,847,847,-3,-3,3,true,-1.0
2,1,0.5,0.5,true,false,300,350,799,949,499,599,1,true,1155.845
2,1,0.5,0.5,true,false,250,250,247,247,-3,-3,3,true,-1.0
2,1,0.5,0.5,true,false,250,300,298,798,48,498,2,true,-1.0
2,1,0.5,0.5,true,false,200,200,197,197,-3,-3,3,true,-1.0
2,1,0.5,0.5,true,false,200,850,197,847,-3,-3,3,true,-1.0
2,1,0.5,0.5,true,false,300,300,297,297,-3,-3,3,true,-1.0
2,1,0.5,0.5,true,false,300,250,799,299,499,49,1,true,-1.0
2,1,0.5,0.5,true,false,300,300,297,297,-3,-3,3,true,-1.0
2,1,0.5,0.5,true,false,300,300,300,300,0,0,0,true,-1.0
2,1,0.5,0.5,true,false,200,200,150,150,-50,-50,50,false,-1.0
2,1,0.5,0.5,false,false,300,300,299,299,-1,-1,1,true,160.121
2,1,0.5,0.5,false,false,850,200,850,200,0,0,0,true,-1.0
2,1,0.5,0.5,false,false,200,200,248,798,48,598,2,true,-1.0
2,1,0.5,0.5,false,false,300,250,797,397,497,147,3,true,-1.0
2,1,0.5,0.5,false,false,250,300,249,299,-1,-1,1,false,-1.0
2,1,0.5,0.5,false,false,250,250,247,247,-3,-3,3,true,-1.0
2,1,0.5,0.5,false,false,200,300,799,899,599,599,1,true,-1.0
2,1,0.5,0.5,false,false,250,250,247,247,-3,-3,3,true,-1.0
2,1,0.5,0.5,false,false,300,350,797,397,497,47,3,true,-1.0
2,1,0.5,0.5,false,false,300,250,898,798,598,548,2,true,-1.0
2,2,0.5,0.5,true,true,850,250,849,249,-1,-1,1,true,365.108
2,2,0.5,0.5,true,true,300,250,300,250,0,0,0,true,-1.0
2,2,0.5,0.5,true,true,300,200,300,200,0,0,0,true,-1.0
2,2,0.5,0.5,true,true,200,250,198,248,-2,-2,2,true,-1.0
2,2,0.5,0.5,true,true,850,250,898,298,48,48,2,true,-1.0
2,2,0.5,0.5,true,true,200,300,198,298,-2,-2,2,true,-1.0
2,2,0.5,0.5,true,true,850,350,849,349,-1,-1,1,true,-1.0
2,2,0.5,0.5,true,true,350,300,899,349,549,49,1,true,-1.0
2,2,0.5,0.5,true,true,300,850,299,849,-1,-1,1,true,-1.0
2,2,0.5,0.5,true,true,250,850,249,849,-1,-1,1,true,-1.0
2,2,0.5,0.5,true,false,250,350,250,350,0,0,0,true,919.631
2,2,0.5,0.5,true,false,250,300,799,899,549,599,1,true,-1.0
2,2,0.5,0.5,true,false,300,250,798,348,498,98,2,true,-1.0
2,2,0.5,0.5,true,false,250,250,299,799,49,549,1,true,-1.0
2,2,0.5,0.5,true,false,300,850,300,850,0,0,0,true,-1.0
2,2,0.5,0.5,true,false,350,200,399,299,49,99,1,true,-1.0
2,2,0.5,0.5,true,false,200,200,200,200,0,0,0,true,-1.0
2,2,0.5,0.5,true,false,850,850,849,849,-1,-1,1,true,-1.0
2,2,0.5,0.5,true,false,850,850,849,849,-1,-1,1,true,-1.0
2,2,0.5,0.5,true,false,850,300,850,300,0,0,0,true,-1.0
2,2,0.5,0.5,false,true,200,250,799,299,599,49,1,true,194.279
2,2,0.5,0.5,false,true,300,200,797,297,497,97,3,true,-1.0
2,2,0.5,0.5,false,true,300,300,797,347,497,47,3,true,-1.0
2,2,0.5,0.5,false,true,200,250,197,247,-3,-3,3,true,-1.0
2,2,0.5,0.5,false,true,200,300,399,799,199,499,1,true,-1.0
2,2,0.5,0.5,false,true,250,200,250,200,0,0,0,true,-1.0
2,2,0.5,0.5,false,true,200,850,248,898,48,48,2,true,-1.0
2,2,0.5,0.5,false,true,300,350,296,346,-4,-4,4,true,-1.0
2,2,0.5,0.5,false,true,200,850,198,848,-2,-2,2,true,-1.0
2,2,0.5,0.5,false,true,250,850,298,898,48,48,2,true,-1.0
2,2,0.5,0.5,false,false,250,200,249,199,-1,-1,1,true,139.74
2,2,0.5,0.5,false,false,300,300,799,349,499,49,1,true,-1.0
2,2,0.5,0.5,false,false,200,200,199,199,-1,-1,1,true,-1.0
2,2,0.5,0.5,false,false,850,300,899,799,49,499,1,true,-1.0
2,2,0.5,0.5,false,false,850,250,849,249,-1,-1,1,true,-1.0
2,2,0.5,0.5,false,false,250,300,298,348,48,48,2,true,-1.0
2,2,0.5,0.5,false,false,300,300,399,799,99,499,1,true,-1.0
2,2,0.5,0.5,false,false,200,900,198,898,-2,-2,2,true,-1.0
2,2,0.5,0.5,false,false,300,850,798,898,498,48,2,true,-1.0
2,2,0.5,0.5,false,false,300,250,349,799,49,549,1,true,-1.0
0,0,0.5,0.5,false,false,200,850,197,847,-3,-3,3,true,0.179
0,0,0.5,0.5,false,false,250,850,247,847,-3,-3,3,true,-1.0
0,0,0.5,0.5,false,false,250,200,247,197,-3,-3,3,true,-1.0
0,0,0.5,0.5,false,false,300,300,947,797,647,497,3,true,-1.0
0,0,0.5,0.5,false,false,300,250,348,798,48,548,2,true,-1.0
0,0,0.5,0.5,false,false,300,300,797,347,497,47,3,true,-1.0
0,0,0.5,0.5,false,false,300,350,346,896,46,546,4,true,-1.0
0,0,0.5,0.5,false,false,300,850,297,847,-3,-3,3,true,-1.0
0,0,0.5,0.5,false,false,250,200,248,198,-2,-2,2,true,-1.0
0,0,0.5,0.5,false,false,250,300,298,798,48,498,2,false,-1.0
0,1,0.5,0.5,false,false,200,200,198,198,-2,-2,2,true,0.299
0,1,0.5,0.5,false,false,300,350,297,347,-3,-3,3,true,-1.0
0,1,0.5,0.5,false,false,300,200,296,196,-4,-4,4,false,-1.0
0,1,0.5,0.5,false,false,250,300,298,848,48,548,2,true,-1.0
0,1,0.5,0.5,false,false,200,250,196,246,-4,-4,4,true,-1.0
0,1,0.5,0.5,false,false,300,300,296,296,-4,-4,4,true,-1.0
0,1,0.5,0.5,false,false,250,250,249,249,-1,-1,1,true,-1.0
0,1,0.5,0.5,false,false,250,200,248,198,-2,-2,2,true,-1.0
0,1,0.5,0.5,false,false,200,850,196,846,-4,-4,4,true,-1.0
0,1,0.5,0.5,false,false,200,200,198,198,-2,-2,2,true,-1.0
0,2,0.5,0.5,false,true,200,300,248,798,48,498,2,true,371.088
0,2,0.5,0.5,false,true,850,250,846,246,-4,-4,4,true,-1.0
0,2,0.5,0.5,false,true,300,900,297,897,-3,-3,3,true,-1.0
0,2,0.5,0.5,false,true,200,300,199,299,-1,-1,1,true,-1.0
0,2,0.5,0.5,false,true,900,200,896,196,-4,-4,4,true,-1.0
0,2,0.5,0.5,false,true,300,200,296,196,-4,-4,4,true,-1.0
0,2,0.5,0.5,false,true,250,350,298,898,48,548,2,true,-1.0
0,2,0.5,0.5,false,true,850,250,846,246,-4,-4,4,true,-1.0
0,2,0.5,0.5,false,true,350,200,349,199,-1,-1,1,true,-1.0
0,2,0.5,0.5,false,true,300,200,296,196,-4,-4,4,false,-1.0
0,2,0.5,0.5,false,false,850,250,846,246,-4,-4,4,false,73.563
0,2,0.5,0.5,false,false,200,250,298,798,98,548,2,true,-1.0
0,2,0.5,0.5,false,false,200,300,799,949,599,649,1,true,-1.0
0,2,0.5,0.5,false,false,200,850,798,898,598,48,2,true,-1.0
0,2,0.5,0.5,false,false,200,850,799,899,599,49,1,true,-1.0
0,2,0.5,0.5,false,false,300,300,799,899,499,599,1,true,-1.0
0,2,0.5,0.5,false,false,300,300,296,296,-4,-4,4,true,-1.0
0,2,0.5,0.5,false,false,300,850,299,849,-1,-1,1,true,-1.0
0,2,0.5,0.5,false,false,250,300,799,349,549,49,1,true,-1.0
0,2,0.5,0.5,false,false,200,350,248,898,48,548,2,true,-1.0
1,0,0.5,0.5,false,false,350,850,347,847,-3,-3,3,true,0.287
1,0,0.5,0.5,false,false,250,250,398,798,148,548,2,true,-1.0
1,0,0.5,0.5,false,false,250,200,250,200,0,0,0,true,-1.0
1,0,0.5,0.5,false,false,200,300,849,849,649,549,1,true,-1.0
1,0,0.5,0.5,false,false,250,200,299,799,49,599,1,true,-1.0
1,0,0.5,0.5,false,false,200,350,195,345,-5,-5,5,false,-1.0
1,0,0.5,0.5,false,false,300,250,297,247,-3,-3,3,true,-1.0
1,0,0.5,0.5,false,false,300,850,297,847,-3,-3,3,true,-1.0
1,0,0.5,0.5,false,false,200,850,195,845,-5,-5,5,true,-1.0
1,0,0.5,0.5,false,false,200,200,197,197,-3,-3,3,true,-1.0
1,1,0.5,0.5,false,false,200,200,200,200,0,0,0,true,1.325
1,1,0.5,0.5,false,false,850,250,848,248,-2,-2,2,true,-1.0
1,1,0.5,0.5,false,false,850,250,850,250,0,0,0,true,-1.0
1,1,0.5,0.5,false,false,850,300,899,799,49,499,1,true,-1.0
1,1,0.5,0.5,false,false,250,200,250,200,0,0,0,true,-1.0
1,1,0.5,0.5,false,false,300,250,250,200,-50,-50,50,false,-1.0
1,1,0.5,0.5,false,false,250,300,797,347,547,47,3,true,-1.0
1,1,0.5,0.5,false,false,300,200,799,349,499,149,1,true,-1.0
1,1,0.5,0.5,false,false,350,850,347,847,-3,-3,3,true,-1.0
1,1,0.5,0.5,false,false,300,300,300,300,0,0,0,true,-1.0
1,2,0.5,0.5,false,true,200,350,200,350,0,0,0,true,773.76
1,2,0.5,0.5,false,true,850,250,850,250,0,0,0,true,-1.0
1,2,0.5,0.5,false,true,850,300,800,250,-50,-50,50,false,-1.0
1,2,0.5,0.5,false,true,850,250,848,248,-2,-2,2,true,-1.0
1,2,0.5,0.5,false,true,300,200,899,349,599,149,1,true,-1.0
1,2,0.5,0.5,false,true,300,350,848,898,548,548,2,true,-1.0
1,2,0.5,0.5,false,true,350,300,348,298,-2,-2,2,true,-1.0
1,2,0.5,0.5,false,true,850,350,849,349,-1,-1,1,true,-1.0
1,2,0.5,0.5,false,true,200,850,199,849,-1,-1,1,true,-1.0
1,2,0.5,0.5,false,true,250,200,799,299,549,99,1,true,-1.0
1,2,0.5,0.5,false,false,200,300,347,797,147,497,3,true,139.453
1,2,0.5,0.5,false,false,300,300,799,899,499,599,1,true,-1.0
1,2,0.5,0.5,false,false,850,300,850,300,0,0,0,true,-1.0
1,2,0.5,0.5,false,false,250,300,200,250,-50,-50,50,false,-1.0
1,2,0.5,0.5,false,false,300,900,799,949,499,49,1,true,-1.0
1,2,0.5,0.5,false,false,850,250,850,250,0,0,0,true,-1.0
1,2,0.5,0.5,false,false,900,200,919,219,19,19,31,true,-1.0
1,2,0.5,0.5,false,false,350,300,348,298,-2,-2,2,true,-1.0
1,2,0.5,0.5,false,false,300,300,349,799,49,499,1,true,-1.0
1,2,0.5,0.5,false,false,350,250,399,799,49,549,1,true,-1.0
2,0,0.5,0.5,true,false,850,300,898,798,48,498,2,true,593.134
2,0,0.5,0.5,true,false,250,250,247,247,-3,-3,3,true,-1.0
2,0,0.5,0.5,true,false,300,200,300,200,0,0,0,true,-1.0
2,0,0.5,0.5,true,false,850,250,897,797,47,547,3,true,-1.0
2,0,0.5,0.5,true,false,200,300,348,798,148,498,2,true,-1.0
2,0,0.5,0.5,true,false,350,850,350,850,0,0,0,true,-1.0
2,0,0.5,0.5,true,false,300,300,297,297,-3,-3,3,true,-1.0
2,0,0.5,0.5,true,false,300,300,300,300,0,0,0,true,-1.0
2,0,0.5,0.5,true,false,300,250,797,297,497,47,3,true,-1.0
2,0,0.5,0.5,true,false,200,200,899,249,699,49,1,true,-1.0
2,0,0.5,0.5,false,false,250,300,797,347,547,47,3,true,93.393
2,0,0.5,0.5,false,false,850,250,845,245,-5,-5,5,true,-1.0
2,0,0.5,0.5,false,false,200,900,197,897,-3,-3,3,true,-1.0
2,0,0.5,0.5,false,false,250,200,347,247,97,47,3,true,-1.0
2,0,0.5,0.5,false,false,200,200,195,195,-5,-5,5,true,-1.0
2,0,0.5,0.5,false,false,200,200,197,197,-3,-3,3,true,-1.0
2,0,0.5,0.5,false,false,300,250,897,847,597,597,3,true,-1.0
2,0,0.5,0.5,false,false,300,200,397,247,97,47,3,true,-1.0
2,0,0.5,0.5,false,false,300,200,297,197,-3,-3,3,true,-1.0
2,0,0.5,0.5,false,false,200,300,898,798,698,498,2,true,-1.0
2,1,0.5,0.5,true,false,250,200,899,249,649,49,1,true,784.061
2,1,0.5,0.5,true,false,300,300,297,297,-3,-3,3,true,-1.0
2,1,0.5,0.5,true,false,850,300,847,297,-3,-3,3,true,-1.0
2,1,0.5,0.5,true,false,300,350,796,396,496,46,4,true,-1.0
2,1,0.5,0.5,true,false,200,300,200,300,0,0,0,true,-1.0
2,1,0.5,0.5,true,false,250,250,200,200,-50,-50,50,true,-1.0
2,1,0.5,0.5,true,false,900,200,949,249,49,49,1,true,-1.0
2,1,0.5,0.5,true,false,300,250,848,848,548,598,2,true,-1.0
2,1,0.5,0.5,true,false,200,300,197,297,-3,-3,3,true,-1.0
2,1,0.5,0.5,true,false,300,900,797,947,497,47,3,true,-1.0
2,1,0.5,0.5,false,false,250,250,243,243,-7,-7,7,true,138.965
2,1,0.5,0.5,false,false,900,300,948,798,48,498,2,true,-1.0
2,1,0.5,0.5,false,false,200,200,249,299,49,99,1,false,-1.0
2,1,0.5,0.5,false,false,250,850,247,847,-3,-3,3,true,-1.0
2,1,0.5,0.5,false,false,250,200,247,197,-3,-3,3,true,-1.0
2,1,0.5,0.5,false,false,350,350,347,347,-3,-3,3,true,-1.0
2,1,0.5,0.5,false,false,250,250,247,247,-3,-3,3,true,-1.0
2,1,0.5,0.5,false,false,250,850,247,847,-3,-3,3,true,-1.0
2,1,0.5,0.5,false,false,250,850,247,847,-3,-3,3,true,-1.0
2,1,0.5,0.5,false,false,350,300,897,847,547,547,3,true,-1.0
2,2,0.5,0.5,true,true,350,250,899,849,549,599,1,true,866.463
2,2,0.5,0.5,true,true,850,250,845,245,-5,-5,5,true,-1.0
2,2,0.5,0.5,true,true,200,850,199,849,-1,-1,1,true,-1.0
2,2,0.5,0.5,true,true,200,300,849,849,649,549,1,true,-1.0
2,2,0.5,0.5,true,true,200,300,150,250,-50,-50,50,true,-1.0
2,2,0.5,0.5,true,true,350,300,899,349,549,49,1,true,-1.0
2,2,0.5,0.5,true,true,300,900,798,948,498,48,2,true,-1.0
2,2,0.5,0.5,true,true,300,200,300,200,0,0,0,true,-1.0
2,2,0.5,0.5,true,true,200,300,199,299,-1,-1,1,true,-1.0
2,2,0.5,0.5,true,true,850,300,849,299,-1,-1,1,true,-1.0
2,2,0.5,0.5,true,false,300,200,797,247,497,47,3,true,513.779
2,2,0.5,0.5,true,false,200,250,798,898,598,648,2,true,-1.0
2,2,0.5,0.5,true,false,300,200,300,200,0,0,0,true,-1.0
2,2,0.5,0.5,true,false,300,300,300,300,0,0,0,true,-1.0
2,2,0.5,0.5,true,false,200,300,798,398,598,98,2,true,-1.0
2,2,0.5,0.5,true,false,300,250,348,798,48,548,2,true,-1.0
2,2,0.5,0.5,true,false,200,850,199,849,-1,-1,1,false,-1.0
2,2,0.5,0.5,true,false,200,300,199,299,-1,-1,1,true,-1.0
2,2,0.5,0.5,true,false,300,350,798,948,498,598,2,true,-1.0
2,2,0.5,0.5,true,false,850,350,850,350,0,0,0,true,-1.0
2,2,0.5,0.5,false,true,850,200,899,249,49,49,1,true,195.092
2,2,0.5,0.5,false,true,300,200,799,249,499,49,1,true,-1.0
2,2,0.5,0.5,false,true,300,850,798,898,498,48,2,true,-1.0
2,2,0.5,0.5,false,true,250,300,248,298,-2,-2,2,true,-1.0
2,2,0.5,0.5,false,true,850,300,899,799,49,499,1,true,-1.0
2,2,0.5,0.5,false,true,850,850,849,849,-1,-1,1,true,-1.0
2,2,0.5,0.5,false,true,350,350,348,348,-2,-2,2,true,-1.0
2,2,0.5,0.5,false,true,200,250,197,247,-3,-3,3,true,-1.0
2,2,0.5,0.5,false,true,300,200,300,200,0,0,0,true,-1.0
2,2,0.5,0.5,false,true,300,200,300,200,0,0,0,true,-1.0
2,2,0.5,0.5,false,false,300,300,299,299,-1,-1,1,true,112.113
2,2,0.5,0.5,false,false,250,250,798,298,548,48,2,true,-1.0
2,2,0.5,0.5,false,false,250,300,298,848,48,548,2,true,-1.0
2,2,0.5,0.5,false,false,200,300,200,300,0,0,0,true,-1.0
2,2,0.5,0.5,false,false,200,300,249,799,49,499,1,true,-1.0
2,2,0.5,0.5,false,false,300,850,797,897,497,47,3,true,-1.0
2,2,0.5,0.5,false,false,250,200,250,200,0,0,0,true,-1.0
2,2,0.5,0.5,false,false,350,250,349,249,-1,-1,1,true,-1.0
2,2,0.5,0.5,false,false,200,200,200,200,0,0,0,true,-1.0
2,2,0.5,0.5,false,false,250,300,299,799,49,499,1,true,-1.0
0,0,0.5,0.5,false,false,250,200,246,196,-4,-4,4,true,0.193
0,0,0.5,0.5,false,false,200,300,197,297,-3,-3,3,false,-1.0
0,0,0.5,0.5,false,false,300,250,949,299,649,49,1,true,-1.0
0,0,0.5,0.5,false,false,250,300,799,949,549,649,1,true,-1.0
0,0,0.5,0.5,false,false,350,300,398,798,48,498,2,true,-1.0
0,0,0.5,0.5,false,false,300,300,348,798,48,498,2,true,-1.0
0,0,0.5,0.5,false,false,200,850,197,847,-3,-3,3,true,-1.0
0,0,0.5,0.5,false,false,250,250,298,798,48,548,2,true,-1.0
0,0,0.5,0.5,false,false,300,200,797,247,497,47,3,true,-1.0
0,0,0.5,0.5,false,false,250,850,248,848,-2,-2,2,true,-1.0
0,1,0.5,0.5,false,false,200,300,248,798,48,498,2,false,0.315
0,1,0.5,0.5,false,false,200,300,198,298,-2,-2,2,true,-1.0
0,1,0.5,0.5,false,false,250,300,246,296,-4,-4,4,true,-1.0
0,1,0.5,0.5,false,false,300,200,296,196,-4,-4,4,true,-1.0
0,1,0.5,0.5,false,false,300,200,298,198,-2,-2,2,true,-1.0
0,1,0.5,0.5,false,false,300,850,296,846,-4,-4,4,true,-1.0
0,1,0.5,0.5,false,false,300,900,797,947,497,47,3,true,-1.0
0,1,0.5,0.5,false,false,300,300,348,798,48,498,2,true,-1.0
0,1,0.5,0.5,false,false,250,300,349,799,99,499,1,true,-1.0
0,1,0.5,0.5,false,false,850,250,898,798,48,548,2,true,-1.0
0,2,0.5,0.5,false,true,200,300,298,898,98,598,2,false,355.147
0,2,0.5,0.5,false,true,850,250,846,246,-4,-4,4,true,-1.0
0,2,0.5,0.5,false,true,200,300,348,798,148,498,2,true,-1.0
0,2,0.5,0.5,false,true,300,200,298,198,-2,-2,2,true,-1.0
0,2,0.5,0.5,false,true,300,250,299,249,-1,-1,1,true,-1.0
0,2,0.5,0.5,false,true,300,300,298,298,-2,-2,2,true,-1.0
0,2,0.5,0.5,false,true,250,250,246,246,-4,-4,4,true,-1.0
0,2,0.5,0.5,false,true,850,250,846,246,-4,-4,4,true,-1.0
0,2,0.5,0.5,false,true,250,250,298,898,48,648,2,true,-1.0
0,2,0.5,0.5,false,true,350,300,948,798,598,498,2,true,-1.0
0,2,0.5,0.5,false,false,250,900,246,896,-4,-4,4,true,77.879
0,2,0.5,0.5,false,false,900,200,896,196,-4,-4,4,true,-1.0
0,2,0.5,0.5,false,false,250,200,398,798,148,598,2,true,-1.0
0,2,0.5,0.5,false,false,300,350,296,346,-4,-4,4,true,-1.0
0,2,0.5,0.5,false,false,300,250,799,399,499,149,1,true,-1.0
0,2,0.5,0.5,false,false,850,900,846,896,-4,-4,4,true,-1.0
0,2,0.5,0.5,false,false,350,350,349,349,-1,-1,1,true,-1.0
0,2,0.5,0.5,false,false,850,300,846,296,-4,-4,4,true,-1.0
0,2,0.5,0.5,false,false,200,300,196,296,-4,-4,4,true,-1.0
0,2,0.5,0.5,false,false,200,850,248,898,48,48,2,true,-1.0
1,0,0.5,0.5,false,false,200,200,197,197,-3,-3,3,true,0.323
1,0,0.5,0.5,false,false,300,300,297,297,-3,-3,3,true,-1.0
1,0,0.5,0.5,false,false,900,850,897,847,-3,-3,3,true,-1.0
1,0,0.5,0.5,false,false,850,300,850,300,0,0,0,true,-1.0
1,0,0.5,0.5,false,false,850,850,847,847,-3,-3,3,true,-1.0
1,0,0.5,0.5,false,false,200,300,197,297,-3,-3,3,true,-1.0
1,0,0.5,0.5,false,false,250,850,247,847,-3,-3,3,true,-1.0
1,0,0.5,0.5,false,false,200,300,799,349,599,49,1,true,-1.0
1,0,0.5,0.5,false,false,300,300,799,399,499,99,1,true,-1.0
1,0,0.5,0.5,false,false,300,300,797,347,497,47,3,true,-1.0
1,1,0.5,0.5,false,false,300,200,250,150,-50,-50,50,true,1.489
1,1,0.5,0.5,false,false,200,250,248,798,48,548,2,true,-1.0
1,1,0.5,0.5,false,false,250,300,297,347,47,47,3,true,-1.0
1,1,0.5,0.5,false,false,250,250,247,247,-3,-3,3,true,-1.0
1,1,0.5,0.5,false,false,200,250,150,200,-50,-50,50,true,-1.0
1,1,0.5,0.5,false,false,850,250,800,200,-50,-50,50,false,-1.0
1,1,0.5,0.5,false,false,200,300,197,297,-3,-3,3,true,-1.0
1,1,0.5,0.5,false,false,200,850,799,899,599,49,1,true,-1.0
1,1,0.5,0.5,false,false,250,200,799,249,549,49,1,true,-1.0
1,1,0.5,0.5,false,false,300,200,300,200,0,0,0,true,-1.0
1,2,0.5,0.5,false,true,850,250,848,248,-2,-2,2,true,996.576
1,2,0.5,0.5,false,true,250,200,200,150,-50,-50,50,false,-1.0
1,2,0.5,0.5,false,true,200,300,298,898,98,598,2,true,-1.0
1,2,0.5,0.5,false,true,850,250,850,250,0,0,0,true,-1.0
1,2,0.5,0.5,false,true,300,300,250,250,-50,-50,50,false,-1.0
1,2,0.5,0.5,false,true,300,250,296,246,-4,-4,4,true,-1.0
1,2,0.5,0.5,false,true,200,850,198,848,-2,-2,2,true,-1.0
1,2,0.5,0.5,false,true,850,250,846,246,-4,-4,4,true,-1.0
1,2,0.5,0.5,false,true,850,300,898,798,48,498,2,true,-1.0
1,2,0.5,0.5,false,true,300,250,299,249,-1,-1,1,false,-1.0
1,2,0.5,0.5,false,false,850,250,850,250,0,0,0,true,93.35
1,2,0.5,0.5,false,false,200,250,225,275,25,25,25,true,-1.0
1,2,0.5,0.5,false,false,250,850,248,848,-2,-2,2,true,-1.0
1,2,0.5,0.5,false,false,350,250,350,250,0,0,0,true,-1.0
1,2,0.5,0.5,false,false,300,300,349,799,49,499,1,true,-1.0
1,2,0.5,0.5,false,false,850,250,848,248,-2,-2,2,true,-1.0
1,2,0.5,0.5,false,false,200,200,200,200,0,0,0,true,-1.0
1,2,0.5,0.5,false,false,350,350,348,348,-2,-2,2,true,-1.0
1,2,0.5,0.5,false,false,300,200,799,899,499,699,1,true,-1.0
1,2,0.5,0.5,false,false,300,300,298,298,-2,-2,2,true,-1.0
2,0,0.5,0.5,true,false,350,250,345,245,-5,-5,5,true,619.742
2,0,0.5,0.5,true,false,300,250,296,246,-4,-4,4,true,-1.0
2,0,0.5,0.5,true,false,300,250,349,799,49,549,1,false,-1.0
2,0,0.5,0.5,true,false,200,250,247,297,47,47,3,true,-1.0
2,0,0.5,0.5,true,false,200,200,200,200,0,0,0,true,-1.0
2,0,0.5,0.5,true,false,850,200,850,200,0,0,0,true,-1.0
2,0,0.5,0.5,true,false,250,850,247,847,-3,-3,3,true,-1.0
2,0,0.5,0.5,true,false,250,350,245,345,-5,-5,5,false,-1.0
2,0,0.5,0.5,true,false,250,300,247,297,-3,-3,3,true,-1.0
2,0,0.5,0.5,true,false,200,250,897,297,697,47,3,true,-1.0
2,0,0.5,0.5,false,false,350,300,347,297,-3,-3,3,true,114.128
2,0,0.5,0.5,false,false,200,350,197,347,-3,-3,3,true,-1.0
2,0,0.5,0.5,false,false,250,300,250,300,0,0,0,true,-1.0
2,0,0.5,0.5,false,false,250,300,847,347,597,47,3,true,-1.0
2,0,0.5,0.5,false,false,300,200,797,347,497,147,3,true,-1.0
2,0,0.5,0.5,false,false,200,200,200,200,0,0,0,true,-1.0
2,0,0.5,0.5,false,false,200,200,195,195,-5,-5,5,true,-1.0
2,0,0.5,0.5,false,false,300,300,349,799,49,499,1,true,-1.0
2,0,0.5,0.5,false,false,300,300,398,798,98,498,2,true,-1.0
2,0,0.5,0.5,false,false,300,850,297,847,-3,-3,3,true,-1.0
2,1,0.5,0.5,true,false,200,200,899,249,699,49,1,true,984.32
2,1,0.5,0.5,true,false,250,200,299,249,49,49,1,true,-1.0
2,1,0.5,0.5,true,false,200,850,199,849,-1,-1,1,true,-1.0
2,1,0.5,0.5,true,false,200,250,197,247,-3,-3,3,true,-1.0
2,1,0.5,0.5,true,false,200,200,249,299,49,99,1,true,-1.0
2,1,0.5,0.5,true,false,250,250,247,247,-3,-3,3,true,-1.0
2,1,0.5,0.5,true,false,250,300,247,297,-3,-3,3,false,-1.0
2,1,0.5,0.5,true,false,300,200,799,249,499,49,1,true,-1.0
2,1,0.5,0.5,true,false,300,350,300,350,0,0,0,true,-1.0
2,1,0.5,0.5,true,false,250,250,299,799,49,549,1,true,-1.0
2,1,0.5,0.5,false,false,200,250,197,247,-3,-3,3,true,139.812
2,1,0.5,0.5,false,false,850,300,847,297,-3,-3,3,true,-1.0
2,1,0.5,0.5,false,false,250,200,200,150,-50,-50,50,false,-1.0
2,1,0.5,0.5,false,false,850,850,847,847,-3,-3,3,true,-1.0
2,1,0.5,0.5,false,false,200,300,899,899,699,599,1,true,-1.0
2,1,0.5,0.5,false,false,250,300,349,799,99,499,1,false,-1.0
2,1,0.5,0.5,false,false,350,300,347,297,-3,-3,3,true,-1.0
2,1,0.5,0.5,false,false,850,300,847,297,-3,-3,3,true,-1.0
2,1,0.5,0.5,false,false,300,300,300,300,0,0,0,true,-1.0
2,1,0.5,0.5,false,false,350,200,899,299,549,99,1,true,-1.0
2,2,0.5,0.5,true,true,850,250,849,249,-1,-1,1,true,411.438
2,2,0.5,0.5,true,true,200,200,200,200,0,0,0,true,-1.0
2,2,0.5,0.5,true,true,250,850,248,848,-2,-2,2,true,-1.0
2,2,0.5,0.5,true,true,250,350,248,348,-2,-2,2,true,-1.0
2,2,0.5,0.5,true,true,200,300,198,298,-2,-2,2,true,-1.0
2,2,0.5,0.5,true,true,300,350,799,399,499,49,1,true,-1.0
2,2,0.5,0.5,true,true,250,250,949,799,699,549,1,true,-1.0
2,2,0.5,0.5,true,true,300,300,797,347,497,47,3,true,-1.0
2,2,0.5,0.5,true,true,250,300,798,348,548,48,2,true,-1.0
2,2,0.5,0.5,true,true,300,250,299,249,-1,-1,1,true,-1.0
2,2,0.5,0.5,true,false,250,850,797,897,547,47,3,true,538.686
2,2,0.5,0.5,true,false,350,300,348,298,-2,-2,2,true,-1.0
2,2,0.5,0.5,true,false,300,250,899,299,599,49,1,true,-1.0
2,2,0.5,0.5,true,false,300,850,798,898,498,48,2,true,-1.0
2,2,0.5,0.5,true,false,200,200,799,249,599,49,1,true,-1.0
2,2,0.5,0.5,true,false,300,300,348,798,48,498,2,true,-1.0
2,2,0.5,0.5,true,false,300,300,798,348,498,48,2,true,-1.0
2,2,0.5,0.5,true,false,350,250,350,250,0,0,0,true,-1.0
2,2,0.5,0.5,true,false,850,350,850,350,0,0,0,true,-1.0
2,2,0.5,0.5,true,false,300,250,798,298,498,48,2,true,-1.0
2,2,0.5,0.5,false,true,250,250,849,849,599,599,1,true,164.027
2,2,0.5,0.5,false,true,850,200,849,199,-1,-1,1,true,-1.0
2,2,0.5,0.5,false,true,300,300,797,347,497,47,3,true,-1.0
2,2,0.5,0.5,false,true,250,250,248,248,-2,-2,2,true,-1.0
2,2,0.5,0.5,false,true,850,900,849,899,-1,-1,1,true,-1.0
2,2,0.5,0.5,false,true,300,300,349,799,49,499,1,true,-1.0
2,2,0.5,0.5,false,true,250,300,249,299,-1,-1,1,true,-1.0
2,2,0.5,0.5,false,true,200,850,249,899,49,49,1,true,-1.0
2,2,0.5,0.5,false,true,250,250,299,799,49,549,1,true,-1.0
2,2,0.5,0.5,false,true,200,850,298,898,98,48,2,true,-1.0
2,2,0.5,0.5,false,false,300,300,298,298,-2,-2,2,true,161.735
2,2,0.5,0.5,false,false,300,250,349,299,49,49,1,true,-1.0
2,2,0.5,0.5,false,false,300,300,299,299,-1,-1,1,true,-1.0
2,2,0.5,0.5,false,false,250,250,249,249,-1,-1,1,true,-1.0
2,2,0.5,0.5,false,false,300,300,298,298,-2,-2,2,true,-1.0
2,2,0.5,0.5,false,false,200,200,150,150,-50,-50,50,false,-1.0
2,2,0.5,0.5,false,false,300,300,300,300,0,0,0,true,-1.0
2,2,0.5,0.5,false,false,250,850,249,849,-1,-1,1,true,-1.0
2,2,0.5,0.5,false,false,300,300,299,299,-1,-1,1,true,-1.0
2,2,0.5,0.5,false,false,300,350,799,399,499,49,1,true,-1.0
0,0,0.5,0.5,false,false,350,250,348,248,-2,-2,2,true,0.235
0,0,0.5,0.5,false,false,300,200,797,247,497,47,3,true,-1.0
0,0,0.5,0.5,false,false,300,300,348,798,48,498,2,true,-1.0
0,0,0.5,0.5,false,false,250,350,247,347,-3,-3,3,true,-1.0
0,0,0.5,0.5,false,false,250,250,799,299,549,49,1,true,-1.0
0,0,0.5,0.5,false,false,300,300,348,798,48,498,2,true,-1.0
0,0,0.5,0.5,false,false,200,300,248,798,48,498,2,true,-1.0
0,0,0.5,0.5,false,false,200,300,898,798,698,498,2,true,-1.0
0,0,0.5,0.5,false,false,250,300,248,298,-2,-2,2,true,-1.0
0,0,0.5,0.5,false,false,300,350,296,346,-4,-4,4,false,-1.0
0,1,0.5,0.5,false,false,300,300,797,347,497,47,3,true,0.314
0,1,0.5,0.5,false,false,300,250,797,347,497,97,3,true,-1.0
0,1,0.5,0.5,false,false,250,200,296,246,46,46,4,true,-1.0
0,1,0.5,0.5,false,false,250,200,298,348,48,148,2,true,-1.0
0,1,0.5,0.5,false,false,250,300,298,398,48,98,2,true,-1.0
0,1,0.5,0.5,false,false,350,300,948,798,598,498,2,true,-1.0
0,1,0.5,0.5,false,false,250,250,348,798,98,548,2,true,-1.0
0,1,0.5,0.5,false,false,200,250,248,348,48,98,2,true,-1.0
0,1,0.5,0.5,false,false,350,300,398,798,48,498,2,true,-1.0
0,1,0.5,0.5,false,false,250,200,348,798,98,598,2,true,-1.0
0,2,0.5,0.5,false,true,250,350,247,347,-3,-3,3,true,409.184
0,2,0.5,0.5,false,true,300,900,297,897,-3,-3,3,true,-1.0
0,2,0.5,0.5,false,true,250,300,799,349,549,49,1,true,-1.0
0,2,0.5,0.5,false,true,250,250,799,949,549,699,1,true,-1.0
0,2,0.5,0.5,false,true,300,200,799,249,499,49,1,true,-1.0
0,2,0.5,0.5,false,true,250,300,298,798,48,498,2,true,-1.0
0,2,0.5,0.5,false,true,850,300,848,298,-2,-2,2,true,-1.0
0,2,0.5,0.5,false,true,350,250,346,246,-4,-4,4,true,-1.0
0,2,0.5,0.5,false,true,350,300,897,897,547,597,3,true,-1.0
0,2,0.5,0.5,false,true,300,200,299,199,-1,-1,1,true,-1.0
0,2,0.5,0.5,false,false,350,300,346,296,-4,-4,4,true,64.461
0,2,0.5,0.5,false,false,200,850,248,898,48,48,2,true,-1.0
0,2,0.5,0.5,false,false,850,900,849,899,-1,-1,1,true,-1.0
0,2,0.5,0.5,false,false,200,300,248,348,48,48,2,true,-1.0
0,2,0.5,0.5,false,false,300,200,296,196,-4,-4,4,true,-1.0
0,2,0.5,0.5,false,false,850,300,846,296,-4,-4,4,true,-1.0
0,2,0.5,0.5,false,false,350,250,346,246,-4,-4,4,true,-1.0
0,2,0.5,0.5,false,false,300,300,296,296,-4,-4,4,true,-1.0
0,2,0.5,0.5,false,false,900,200,948,798,48,598,2,true,-1.0
0,2,0.5,0.5,false,false,300,250,296,246,-4,-4,4,false,-1.0
1,0,0.5,0.5,false,false,850,250,847,247,-3,-3,3,true,0.27
1,0,0.5,0.5,false,false,350,250,399,799,49,549,1,true,-1.0
1,0,0.5,0.5,false,false,250,300,849,849,599,549,1,true,-1.0
1,0,0.5,0.5,false,false,250,200,250,200,0,0,0,true,-1.0
1,0,0.5,0.5,false,false,850,900,850,900,0,0,0,true,-1.0
1,0,0.5,0.5,false,false,300,300,300,300,0,0,0,true,-1.0
1,0,0.5,0.5,false,false,200,300,799,949,599,649,1,true,-1.0
1,0,0.5,0.5,false,false,350,850,347,847,-3,-3,3,true,-1.0
1,0,0.5,0.5,false,false,200,900,197,897,-3,-3,3,true,-1.0
1,0,0.5,0.5,false,false,350,850,347,847,-3,-3,3,true,-1.0
1,1,0.5,0.5,false,false,250,350,250,350,0,0,0,true,1.269
1,1,0.5,0.5,false,false,350,250,348,248,-2,-2,2,true,-1.0
1,1,0.5,0.5,false,false,850,250,800,200,-50,-50,50,true,-1.0
1,1,0.5,0.5,false,false,300,300,300,300,0,0,0,true,-1.0
1,1,0.5,0.5,false,false,300,300,349,799,49,499,1,true,-1.0
1,1,0.5,0.5,false,false,300,200,899,299,599,99,1,true,-1.0
1,1,0.5,0.5,false,false,200,200,150,150,-50,-50,50,true,-1.0
1,1,0.5,0.5,false,false,250,300,797,347,547,47,3,true,-1.0
1,1,0.5,0.5,false,false,300,900,798,948,498,48,2,true,-1.0
1,1,0.5,0.5,false,false,850,300,899,799,49,499,1,true,-1.0
1,2,0.5,0.5,false,true,250,850,797,897,547,47,3,true,494.507
1,2,0.5,0.5,false,true,850,200,848,198,-2,-2,2,false,-1.0
1,2,0.5,0.5,false,true,250,250,248,248,-2,-2,2,true,-1.0
1,2,0.5,0.5,false,true,300,300,799,899,499,599,1,true,-1.0
1,2,0.5,0.5,false,true,250,250,250,250,0,0,0,true,-1.0
1,2,0.5,0.5,false,true,200,300,200,300,0,0,0,true,-1.0
1,2,0.5,0.5,false,true,250,200,250,200,0,0,0,true,-1.0
1,2,0.5,0.5,false,true,300,250,397,797,97,547,3,true,-1.0
1,2,0.5,0.5,false,true,200,200,200,200,0,0,0,true,-1.0
1,2,0.5,0.5,false,true,300,300,250,250,-50,-50,50,false,-1.0
1,2,0.5,0.5,false,false,350,300,893,343,543,43,7,true,101.265
1,2,0.5,0.5,false,false,300,850,298,848,-2,-2,2,true,-1.0
1,2,0.5,0.5,false,false,200,250,198,248,-2,-2,2,true,-1.0
1,2,0.5,0.5,false,false,250,250,250,250,0,0,0,true,-1.0
1,2,0.5,0.5,false,false,250,300,298,798,48,498,2,true,-1.0
1,2,0.5,0.5,false,false,350,250,348,248,-2,-2,2,true,-1.0
1,2,0.5,0.5,false,false,300,300,296,296,-4,-4,4,true,-1.0
1,2,0.5,0.5,false,false,250,250,250,250,0,0,0,true,-1.0
1,2,0.5,0.5,false,false,850,850,848,848,-2,-2,2,true,-1.0
1,2,0.5,0.5,false,false,250,900,249,899,-1,-1,1,true,-1.0
2,0,0.5,0.5,true,false,250,850,247,847,-3,-3,3,true,617.088
2,0,0.5,0.5,true,false,850,300,845,295,-5,-5,5,true,-1.0
2,0,0.5,0.5,true,false,250,200,897,297,647,97,3,false,-1.0
2,0,0.5,0.5,true,false,250,250,797,347,547,97,3,true,-1.0
2,0,0.5,0.5,true,false,300,300,797,347,497,47,3,true,-1.0
2,0,0.5,0.5,true,false,300,300,297,297,-3,-3,3,true,-1.0
2,0,0.5,0.5,true,false,250,200,250,200,0,0,0,true,-1.0
2,0,0.5,0.5,true,false,250,300,396,796,146,496,4,true,-1.0
2,0,0.5,0.5,true,false,350,850,347,847,-3,-3,3,true,-1.0
2,0,0.5,0.5,true,false,350,200,948,798,598,598,2,true,-1.0
2,0,0.5,0.5,false,false,300,200,300,200,0,0,0,true,82.589
2,0,0.5,0.5,false,false,300,300,295,295,-5,-5,5,false,-1.0
2,0,0.5,0.5,false,false,250,200,250,200,0,0,0,true,-1.0
2,0,0.5,0.5,false,false,300,350,295,345,-5,-5,5,true,-1.0
2,0,0.5,0.5,false,false,200,300,197,297,-3,-3,3,false,-1.0
2,0,0.5,0.5,false,false,300,250,297,247,-3,-3,3,true,-1.0
2,0,0.5,0.5,false,false,250,250,797,897,547,647,3,true,-1.0
2,0,0.5,0.5,false,false,300,200,300,200,0,0,0,true,-1.0
2,0,0.5,0.5,false,false,250,300,247,297,-3,-3,3,true,-1.0
2,0,0.5,0.5,false,false,850,250,850,250,0,0,0,true,-1.0
2,1,0.5,0.5,true,false,850,850,850,850,0,0,0,true,865.484
2,1,0.5,0.5,true,false,200,300,249,799,49,499,1,true,-1.0
2,1,0.5,0.5,true,false,300,200,899,249,599,49,1,false,-1.0
2,1,0.5,0.5,true,false,200,300,197,297,-3,-3,3,true,-1.0
2,1,0.5,0.5,true,false,200,250,248,798,48,548,2,true,-1.0
2,1,0.5,0.5,true,false,300,250,898,798,598,548,2,true,-1.0
2,1,0.5,0.5,true,false,200,250,150,200,-50,-50,50,false,-1.0
2,1,0.5,0.5,true,false,200,350,797,397,597,47,3,true,-1.0
2,1,0.5,0.5,true,false,300,300,344,894,44,594,6,true,-1.0
2,1,0.5,0.5,true,false,250,250,298,798,48,548,2,true,-1.0
2,1,0.5,0.5,false,false,850,250,898,298,48,48,2,true,157.135
2,1,0.5,0.5,false,false,300,200,300,200,0,0,0,true,-1.0
2,1,0.5,0.5,false,false,250,850,797,897,547,47,3,true,-1.0
2,1,0.5,0.5,false,false,200,350,197,347,-3,-3,3,true,-1.0
2,1,0.5,0.5,false,false,200,250,197,247,-3,-3,3,true,-1.0
2,1,0.5,0.5,false,false,200,850,197,847,-3,-3,3,true,-1.0
2,1,0.5,0.5,false,false,250,250,247,247,-3,-3,3,true,-1.0
2,1,0.5,0.5,false,false,200,250,248,298,48,48,2,true,-1.0
2,1,0.5,0.5,false,false,250,850,799,899,549,49,1,true,-1.0
2,1,0.5,0.5,false,false,250,850,799,899,549,49,1,true,-1.0
2,2,0.5,0.5,true,true,300,200,949,249,649,49,1,true,676.096
2,2,0.5,0.5,true,true,250,350,799,949,549,599,1,true,-1.0
2,2,0.5,0.5,true,true,300,300,299,299,-1,-1,1,true,-1.0
2,2,0.5,0.5,true,true,850,850,849,849,-1,-1,1,true,-1.0
2,2,0.5,0.5,true,true,350,300,349,299,-1,-1,1,true,-1.0
2,2,0.5,0.5,true,true,250,300,298,848,48,548,2,true,-1.0
2,2,0.5,0.5,true,true,850,250,850,250,0,0,0,true,-1.0
2,2,0.5,0.5,true,true,900,900,900,900,0,0,0,true,-1.0
2,2,0.5,0.5,true,true,250,850,249,849,-1,-1,1,true,-1.0
2,2,0.5,0.5,true,true,250,300,348,798,98,498,2,false,-1.0
2,2,0.5,0.5,true,false,300,200,299,199,-1,-1,1,true,483.502
2,2,0.5,0.5,true,false,850,850,850,850,0,0,0,true,-1.0
2,2,0.5,0.5,true,false,850,350,849,349,-1,-1,1,true,-1.0
2,2,0.5,0.5,true,false,200,300,248,348,48,48,2,true,-1.0
2,2,0.5,0.5,true,false,250,300,249,299,-1,-1,1,false,-1.0
2,2,0.5,0.5,true,false,300,200,299,199,-1,-1,1,true,-1.0
2,2,0.5,0.5,true,false,300,250,799,299,499,49,1,false,-1.0
2,2,0.5,0.5,true,false,300,300,300,300,0,0,0,true,-1.0
2,2,0.5,0.5,true,false,200,200,197,197,-3,-3,3,true,-1.0
2,2,0.5,0.5,true,false,200,900,200,900,0,0,0,true,-1.0
2,2,0.5,0.5,false,true,850,850,850,850,0,0,0,true,179.888
2,2,0.5,0.5,false,true,200,300,248,348,48,48,2,true,-1.0
2,2,0.5,0.5,false,true,300,850,799,899,499,49,1,true,-1.0
2,2,0.5,0.5,false,true,250,200,299,799,49,599,1,true,-1.0
2,2,0.5,0.5,false,true,300,200,349,799,49,599,1,true,-1.0
2,2,0.5,0.5,false,true,850,850,849,849,-1,-1,1,true,-1.0
2,2,0.5,0.5,false,true,850,300,899,799,49,499,1,true,-1.0
2,2,0.5,0.5,false,true,850,300,899,799,49,499,1,true,-1.0
2,2,0.5,0.5,false,true,250,850,298,898,48,48,2,true,-1.0
2,2,0.5,0.5,false,true,200,300,248,798,48,498,2,false,-1.0
2,2,0.5,0.5,false,false,900,200,899,199,-1,-1,1,true,118.407
2,2,0.5,0.5,false,false,200,300,348,848,148,548,2,true,-1.0
2,2,0.5,0.5,false,false,850,250,850,250,0,0,0,true,-1.0
2,2,0.5,0.5,false,false,300,300,787,337,487,37,13,true,-1.0
2,2,0.5,0.5,false,false,200,850,248,898,48,48,2,true,-1.0
2,2,0.5,0.5,false,false,250,250,250,250,0,0,0,true,-1.0
2,2,0.5,0.5,false,false,200,300,785,335,585,35,15,true,-1.0
2,2,0.5,0.5,false,false,850,250,849,249,-1,-1,1,true,-1.0
2,2,0.5,0.5,false,false,200,300,248,348,48,48,2,true,-1.0
2,2,0.5,0.5,false,false,850,350,849,349,-1,-1,1,true,-1.0
0,0,0.5,0.5,false,false,200,250,197,247,-3,-3,3,true,0.209
0,0,0.5,0.5,false,false,850,850,848,848,-2,-2,2,true,-1.0
0,0,0.5,0.5,false,false,250,200,797,247,547,47,3,true,-1.0
0,0,0.5,0.5,false,false,200,850,297,897,97,47,3,true,-1.0
0,0,0.5,0.5,false,false,300,250,797,897,497,647,3,true,-1.0
0,0,0.5,0.5,false,false,850,300,847,297,-3,-3,3,true,-1.0
0,0,0.5,0.5,false,false,300,250,398,798,98,548,2,true,-1.0
0,0,0.5,0.5,false,false,850,300,846,296,-4,-4,4,true,-1.0
0,0,0.5,0.5,false,false,850,250,848,248,-2,-2,2,false,-1.0
0,0,0.5,0.5,false,false,300,850,297,847,-3,-3,3,true,-1.0
0,1,0.5,0.5,false,false,850,300,846,296,-4,-4,4,true,0.348
0,1,0.5,0.5,false,false,300,250,797,897,497,647,3,true,-1.0
0,1,0.5,0.5,false,false,250,200,248,198,-2,-2,2,true,-1.0
0,1,0.5,0.5,false,false,300,300,296,296,-4,-4,4,true,-1.0
0,1,0.5,0.5,false,false,300,250,797,297,497,47,3,true,-1.0
0,1,0.5,0.5,false,false,300,250,296,246,-4,-4,4,true,-1.0
0,1,0.5,0.5,false,false,250,250,348,798,98,548,2,false,-1.0
0,1,0.5,0.5,false,false,200,850,197,847,-3,-3,3,true,-1.0
0,1,0.5,0.5,false,false,300,850,798,898,498,48,2,true,-1.0
0,1,0.5,0.5,false,false,250,850,247,847,-3,-3,3,true,-1.0
0,2,0.5,0.5,false,true,900,300,898,298,-2,-2,2,false,472.511
0,2,0.5,0.5,false,true,300,300,296,296,-4,-4,4,true,-1.0
0,2,0.5,0.5,false,true,200,250,199,249,-1,-1,1,true,-1.0
0,2,0.5,0.5,false,true,850,300,846,296,-4,-4,4,true,-1.0
0,2,0.5,0.5,false,true,250,850,247,847,-3,-3,3,true,-1.0
0,2,0.5,0.5,false,true,200,300,246,896,46,596,4,true,-1.0
0,2,0.5,0.5,false,true,900,300,896,296,-4,-4,4,true,-1.0
0,2,0.5,0.5,false,true,200,900,196,896,-4,-4,4,true,-1.0
0,2,0.5,0.5,false,true,200,300,248,848,48,548,2,false,-1.0
0,2,0.5,0.5,false,true,300,300,296,296,-4,-4,4,true,-1.0
0,2,0.5,0.5,false,false,200,200,199,199,-1,-1,1,true,64.97
0,2,0.5,0.5,false,false,300,200,948,798,648,598,2,true,-1.0
0,2,0.5,0.5,false,false,300,300,946,796,646,496,4,true,-1.0
0,2,0.5,0.5,false,false,300,850,296,846,-4,-4,4,true,-1.0
0,2,0.5,0.5,false,false,850,250,898,798,48,548,2,true,-1.0
0,2,0.5,0.5,false,false,300,200,348,798,48,598,2,true,-1.0
0,2,0.5,0.5,false,false,250,850,247,847,-3,-3,3,true,-1.0
0,2,0.5,0.5,false,false,300,850,799,899,499,49,1,true,-1.0
0,2,0.5,0.5,false,false,300,250,296,246,-4,-4,4,false,-1.0
0,2,0.5,0.5,false,false,350,250,346,246,-4,-4,4,true,-1.0
1,0,0.5,0.5,false,false,200,300,248,798,48,498,2,false,0.32
1,0,0.5,0.5,false,false,300,200,799,899,499,699,1,true,-1.0
1,0,0.5,0.5,false,false,250,250,299,799,49,549,1,true,-1.0
1,0,0.5,0.5,false,false,300,250,347,297,47,47,3,true,-1.0
1,0,0.5,0.5,false,false,300,300,297,297,-3,-3,3,true,-1.0
1,0,0.5,0.5,false,false,200,250,200,250,0,0,0,true,-1.0
1,0,0.5,0.5,false,false,350,200,345,195,-5,-5,5,true,-1.0
1,0,0.5,0.5,false,false,300,250,799,949,499,699,1,true,-1.0
1,0,0.5,0.5,false,false,250,200,799,899,549,699,1,true,-1.0
1,0,0.5,0.5,false,false,300,300,297,297,-3,-3,3,true,-1.0
1,1,0.5,0.5,false,false,200,200,298,798,98,598,2,true,1.176
1,1,0.5,0.5,false,false,250,300,247,297,-3,-3,3,true,-1.0
1,1,0.5,0.5,false,false,300,250,250,200,-50,-50,50,false,-1.0
1,1,0.5,0.5,false,false,300,300,799,899,499,599,1,true,-1.0
1,1,0.5,0.5,false,false,300,300,948,798,648,498,2,true,-1.0
1,1,0.5,0.5,false,false,850,300,899,799,49,499,1,true,-1.0
1,1,0.5,0.5,false,false,200,850,150,800,-50,-50,50,true,-1.0
1,1,0.5,0.5,false,false,200,300,197,297,-3,-3,3,true,-1.0
1,1,0.5,0.5,false,false,300,250,297,247,-3,-3,3,true,-1.0
1,1,0.5,0.5,false,false,350,200,350,200,0,0,0,true,-1.0
1,2,0.5,0.5,false,true,300,350,300,350,0,0,0,true,476.112
1,2,0.5,0.5,false,true,200,300,799,899,599,599,1,true,-1.0
1,2,0.5,0.5,false,true,850,300,846,296,-4,-4,4,true,-1.0
1,2,0.5,0.5,false,true,250,250,250,250,0,0,0,true,-1.0
1,2,0.5,0.5,false,true,350,250,350,250,0,0,0,true,-1.0
1,2,0.5,0.5,false,true,300,850,298,848,-2,-2,2,true,-1.0
1,2,0.5,0.5,false,true,250,250,246,246,-4,-4,4,true,-1.0
1,2,0.5,0.5,false,true,250,250,398,798,148,548,2,true,-1.0
1,2,0.5,0.5,false,true,850,300,899,799,49,499,1,true,-1.0
1,2,0.5,0.5,false,true,250,200,244,194,-6,-6,6,true,-1.0
1,2,0.5,0.5,false,false,200,300,249,349,49,49,1,false,107.923
1,2,0.5,0.5,false,false,200,300,347,797,147,497,3,true,-1.0
1,2,0.5,0.5,false,false,300,250,298,248,-2,-2,2,true,-1.0
1,2,0.5,0.5,false,false,300,250,799,349,499,99,1,true,-1.0
1,2,0.5,0.5,false,false,250,300,250,300,0,0,0,true,-1.0
1,2,0.5,0.5,false,false,200,200,200,200,0,0,0,true,-1.0
1,2,0.5,0.5,false,false,250,200,248,198,-2,-2,2,true,-1.0
1,2,0.5,0.5,false,false,850,300,850,300,0,0,0,true,-1.0
1,2,0.5,0.5,false,false,850,300,848,298,-2,-2,2,true,-1.0
1,2,0.5,0.5,false,false,300,200,298,198,-2,-2,2,true,-1.0
2,0,0.5,0.5,true,false,200,250,197,247,-3,-3,3,true,571.734
2,0,0.5,0.5,true,false,300,250,797,297,497,47,3,true,-1.0
2,0,0.5,0.5,true,false,250,300,249,799,-1,499,1,true,-1.0
2,0,0.5,0.5,true,false,250,300,797,947,547,647,3,true,-1.0
2,0,0.5,0.5,true,false,250,850,247,847,-3,-3,3,true,-1.0
2,0,0.5,0.5,true,false,250,350,247,347,-3,-3,3,true,-1.0
2,0,0.5,0.5,true,false,300,250,298,248,-2,-2,2,true,-1.0
2,0,0.5,0.5,true,false,350,350,347,347,-3,-3,3,true,-1.0
2,0,0.5,0.5,true,false,300,250,295,245,-5,-5,5,true,-1.0
2,0,0.5,0.5,true,false,850,200,899,249,49,49,1,true,-1.0
2,0,0.5,0.5,false,false,350,300,345,295,-5,-5,5,true,96.096
2,0,0.5,0.5,false,false,200,850,247,897,47,47,3,true,-1.0
2,0,0.5,0.5,false,false,300,200,799,249,499,49,1,true,-1.0
2,0,0.5,0.5,false,false,850,200,845,195,-5,-5,5,true,-1.0
2,0,0.5,0.5,false,false,250,200,297,247,47,47,3,true,-1.0
2,0,0.5,0.5,false,false,300,200,797,247,497,47,3,true,-1.0
2,0,0.5,0.5,false,false,200,850,797,897,597,47,3,true,-1.0
2,0,0.5,0.5,false,false,300,200,300,200,0,0,0,true,-1.0
2,0,0.5,0.5,false,false,250,200,250,200,0,0,0,true,-1.0
2,0,0.5,0.5,false,false,200,250,197,247,-3,-3,3,false,-1.0
2,1,0.5,0.5,true,false,250,200,797,247,547,47,3,true,1090.192
2,1,0.5,0.5,true,false,850,200,899,249,49,49,1,true,-1.0
2,1,0.5,0.5,true,false,300,900,299,899,-1,-1,1,true,-1.0
2,1,0.5,0.5,true,false,200,300,150,250,-50,-50,50,false,-1.0
2,1,0.5,0.5,true,false,300,350,297,347,-3,-3,3,true,-1.0
2,1,0.5,0.5,true,false,850,300,847,297,-3,-3,3,true,-1.0
2,1,0.5,0.5,true,false,300,250,847,347,547,97,3,true,-1.0
2,1,0.5,0.5,true,false,250,250,247,247,-3,-3,3,true,-1.0
2,1,0.5,0.5,true,false,850,250,847,247,-3,-3,3,true,-1.0
2,1,0.5,0.5,true,false,250,300,245,295,-5,-5,5,true,-1.0
2,1,0.5,0.5,false,false,850,850,850,850,0,0,0,true,137.411
2,1,0.5,0.5,false,false,300,300,250,250,-50,-50,50,false,-1.0
2,1,0.5,0.5,false,false,200,300,150,250,-50,-50,50,false,-1.0
2,1,0.5,0.5,false,false,200,350,197,347,-3,-3,3,true,-1.0
2,1,0.5,0.5,false,false,250,350,848,898,598,548,2,true,-1.0
2,1,0.5,0.5,false,false,900,300,897,297,-3,-3,3,true,-1.0
2,1,0.5,0.5,false,false,300,300,798,898,498,598,2,true,-1.0
2,1,0.5,0.5,false,false,300,850,799,899,499,49,1,true,-1.0
2,1,0.5,0.5,false,false,300,350,293,343,-7,-7,7,true,-1.0
2,1,0.5,0.5,false,false,350,300,347,297,-3,-3,3,true,-1.0
2,2,0.5,0.5,true,true,250,300,898,798,648,498,2,true,440.505
2,2,0.5,0.5,true,true,300,300,298,298,-2,-2,2,true,-1.0
2,2,0.5,0.5,true,true,300,200,300,200,0,0,0,true,-1.0
2,2,0.5,0.5,true,true,350,250,396,296,46,46,4,true,-1.0
2,2,0.5,0.5,true,true,850,850,847,847,-3,-3,3,true,-1.0
2,2,0.5,0.5,true,true,300,850,300,850,0,0,0,true,-1.0
2,2,0.5,0.5,true,true,250,300,250,300,0,0,0,true,-1.0
2,2,0.5,0.5,true,true,350,350,348,348,-2,-2,2,true,-1.0
2,2,0.5,0.5,true,true,250,850,249,849,-1,-1,1,true,-1.0
2,2,0.5,0.5,true,true,850,250,849,249,-1,-1,1,true,-1.0
2,2,0.5,0.5,true,false,250,250,299,299,49,49,1,true,473.63
2,2,0.5,0.5,true,false,300,350,798,948,498,598,2,true,-1.0
2,2,0.5,0.5,true,false,850,850,849,849,-1,-1,1,true,-1.0
2,2,0.5,0.5,true,false,300,350,300,350,0,0,0,true,-1.0
2,2,0.5,0.5,true,false,200,200,199,199,-1,-1,1,true,-1.0
2,2,0.5,0.5,true,false,250,850,250,850,0,0,0,true,-1.0
2,2,0.5,0.5,true,false,350,250,349,249,-1,-1,1,true,-1.0
2,2,0.5,0.5,true,false,250,200,399,249,149,49,1,true,-1.0
2,2,0.5,0.5,true,false,350,250,899,849,549,599,1,true,-1.0
2,2,0.5,0.5,true,false,850,300,898,798,48,498,2,true,-1.0
2,2,0.5,0.5,false,true,300,250,298,248,-2,-2,2,true,140.167
2,2,0.5,0.5,false,true,300,300,299,299,-1,-1,1,true,-1.0
2,2,0.5,0.5,false,true,300,300,798,898,498,598,2,true,-1.0
2,2,0.5,0.5,false,true,200,200,200,200,0,0,0,true,-1.0
2,2,0.5,0.5,false,true,300,350,300,350,0,0,0,true,-1.0
2,2,0.5,0.5,false,true,300,300,299,299,-1,-1,1,true,-1.0
2,2,0.5,0.5,false,true,200,250,248,298,48,48,2,true,-1.0
2,2,0.5,0.5,false,true,850,300,850,300,0,0,0,true,-1.0
2,2,0.5,0.5,false,true,250,300,249,299,-1,-1,1,true,-1.0
2,2,0.5,0.5,false,true,350,250,398,798,48,548,2,true,-1.0
2,2,0.5,0.5,false,false,250,200,246,196,-4,-4,4,true,125.89
2,2,0.5,0.5,false,false,200,300,199,299,-1,-1,1,true,-1.0
2,2,0.5,0.5,false,false,200,350,200,350,0,0,0,true,-1.0
2,2,0.5,0.5,false,false,850,300,850,300,0,0,0,true,-1.0
2,2,0.5,0.5,false,false,850,350,849,349,-1,-1,1,true,-1.0
2,2,0.5,0.5,false,false,250,200,785,335,535,135,15,true,-1.0
2,2,0.5,0.5,false,false,300,850,799,899,499,49,1,true,-1.0
2,2,0.5,0.5,false,false,300,200,300,200,0,0,0,true,-1.0
2,2,0.5,0.5,false,false,250,200,326,226,76,26,24,false,-1.0
2,2,0.5,0.5,false,false,850,300,850,300,0,0,0,true,-1.0
0,0,0.5,0.5,false,false,300,250,296,246,-4,-4,4,true,0.193
0,0,0.5,0.5,false,false,300,850,298,848,-2,-2,2,true,-1.0
0,0,0.5,0.5,false,false,350,300,899,849,549,549,1,true,-1.0
0,0,0.5,0.5,false,false,200,300,849,849,649,549,1,true,-1.0
0,0,0.5,0.5,false,false,850,250,846,246,-4,-4,4,true,-1.0
0,0,0.5,0.5,false,false,850,300,896,796,46,496,4,true,-1.0
0,0,0.5,0.5,false,false,350,300,948,798,598,498,2,true,-1.0
0,0,0.5,0.5,false,false,850,900,847,897,-3,-3,3,true,-1.0
0,0,0.5,0.5,false,false,300,250,348,798,48,548,2,false,-1.0
0,0,0.5,0.5,false,false,900,200,897,197,-3,-3,3,true,-1.0
0,1,0.5,0.5,false,false,200,200,197,197,-3,-3,3,true,0.286
0,1,0.5,0.5,false,false,350,300,349,299,-1,-1,1,true,-1.0
0,1,0.5,0.5,false,false,300,850,297,847,-3,-3,3,true,-1.0
0,1,0.5,0.5,false,false,300,200,797,247,497,47,3,true,-1.0
0,1,0.5,0.5,false,false,350,300,346,296,-4,-4,4,true,-1.0
0,1,0.5,0.5,false,false,300,300,799,349,499,49,1,true,-1.0
0,1,0.5,0.5,false,false,200,250,248,348,48,98,2,true,-1.0
0,1,0.5,0.5,false,false,850,250,898,798,48,548,2,true,-1.0
0,1,0.5,0.5,false,false,850,250,846,246,-4,-4,4,true,-1.0
0,1,0.5,0.5,false,false,250,300,297,347,47,47,3,true,-1.0
0,2,0.5,0.5,false,true,200,250,248,798,48,548,2,true,357.519
0,2,0.5,0.5,false,true,850,250,846,246,-4,-4,4,true,-1.0
0,2,0.5,0.5,false,true,250,250,246,246,-4,-4,4,true,-1.0
0,2,0.5,0.5,false,true,200,250,248,298,48,48,2,true,-1.0
0,2,0.5,0.5,false,true,200,300,799,899,599,599,1,true,-1.0
0,2,0.5,0.5,false,true,850,300,849,299,-1,-1,1,true,-1.0
0,2,0.5,0.5,false,true,300,300,296,296,-4,-4,4,true,-1.0
0,2,0.5,0.5,false,true,200,300,199,299,-1,-1,1,true,-1.0
0,2,0.5,0.5,false,true,300,300,799,899,499,599,1,true,-1.0
0,2,0.5,0.5,false,true,850,850,849,849,-1,-1,1,true,-1.0
0,2,0.5,0.5,false,false,250,200,298,848,48,648,2,true,63.469
0,2,0.5,0.5,false,false,300,200,296,196,-4,-4,4,true,-1.0
0,2,0.5,0.5,false,false,300,300,296,296,-4,-4,4,true,-1.0
0,2,0.5,0.5,false,false,300,200,899,249,599,49,1,true,-1.0
0,2,0.5,0.5,false,false,200,250,248,348,48,98,2,false,-1.0
0,2,0.5,0.5,false,false,350,850,347,847,-3,-3,3,true,-1.0
0,2,0.5,0.5,false,false,200,850,799,899,599,49,1,true,-1.0
0,2,0.5,0.5,false,false,250,850,249,849,-1,-1,1,true,-1.0
0,2,0.5,0.5,false,false,250,250,246,246,-4,-4,4,true,-1.0
0,2,0.5,0.5,false,false,850,250,849,249,-1,-1,1,true,-1.0
1,0,0.5,0.5,false,false,300,250,295,245,-5,-5,5,true,0.293
1,0,0.5,0.5,false,false,300,300,799,399,499,99,1,true,-1.0
1,0,0.5,0.5,false,false,300,250,797,297,497,47,3,true,-1.0
1,0,0.5,0.5,false,false,900,350,900,350,0,0,0,true,-1.0
1,0,0.5,0.5,false,false,300,300,300,300,0,0,0,true,-1.0
1,0,0.5,0.5,false,false,350,250,946,796,596,546,4,true,-1.0
1,0,0.5,0.5,false,false,250,200,349,299,99,99,1,true,-1.0
1,0,0.5,0.5,false,false,300,300,296,296,-4,-4,4,true,-1.0
1,0,0.5,0.5,false,false,250,200,250,200,0,0,0,true,-1.0
1,0,0.5,0.5,false,false,300,300,848,848,548,548,2,true,-1.0
1,1,0.5,0.5,false,false,250,300,299,799,49,499,1,true,1.208
1,1,0.5,0.5,false,false,850,200,800,150,-50,-50,50,false,-1.0
1,1,0.5,0.5,false,false,250,300,200,250,-50,-50,50,false,-1.0
1,1,0.5,0.5,false,false,200,850,799,899,599,49,1,true,-1.0
1,1,0.5,0.5,false,false,300,200,300,200,0,0,0,true,-1.0
1,1,0.5,0.5,false,false,250,200,250,200,0,0,0,true,-1.0
1,1,0.5,0.5,false,false,300,350,300,350,0,0,0,false,-1.0
1,1,0.5,0.5,false,false,250,850,297,897,47,47,3,true,-1.0
1,1,0.5,0.5,false,false,350,200,300,150,-50,-50,50,true,-1.0
1,1,0.5,0.5,false,false,350,250,300,200,-50,-50,50,false,-1.0
1,2,0.5,0.5,false,true,300,250,292,242,-8,-8,8,true,793.88
1,2,0.5,0.5,false,true,850,850,848,848,-2,-2,2,true,-1.0
1,2,0.5,0.5,false,true,300,900,798,948,498,48,2,true,-1.0
1,2,0.5,0.5,false,true,200,300,198,298,-2,-2,2,true,-1.0
1,2,0.5,0.5,false,true,350,300,949,799,599,499,1,true,-1.0
1,2,0.5,0.5,false,true,900,250,898,248,-2,-2,2,true,-1.0
1,2,0.5,0.5,false,true,300,250,799,299,499,49,1,true,-1.0
1,2,0.5,0.5,false,true,300,300,296,296,-4,-4,4,true,-1.0
1,2,0.5,0.5,false,true,250,200,200,150,-50,-50,50,false,-1.0
1,2,0.5,0.5,false,true,300,250,300,250,0,0,0,true,-1.0
1,2,0.5,0.5,false,false,850,200,850,200,0,0,0,true,69.772
1,2,0.5,0.5,false,false,200,300,200,300,0,0,0,true,-1.0
1,2,0.5,0.5,false,false,300,250,797,297,497,47,3,true,-1.0
1,2,0.5,0.5,false,false,300,200,349,349,49,149,1,false,-1.0
1,2,0.5,0.5,false,false,850,300,899,799,49,499,1,true,-1.0
1,2,0.5,0.5,false,false,300,250,250,200,-50,-50,50,false,-1.0
1,2,0.5,0.5,false,false,200,850,199,849,-1,-1,1,true,-1.0
1,2,0.5,0.5,false,false,300,200,300,200,0,0,0,true,-1.0
1,2,0.5,0.5,false,false,250,850,249,849,-1,-1,1,true,-1.0
1,2,0.5,0.5,false,false,900,350,898,348,-2,-2,2,true,-1.0
2,0,0.5,0.5,true,false,250,300,797,347,547,47,3,true,610.37
2,0,0.5,0.5,true,false,300,300,300,300,0,0,0,true,-1.0
2,0,0.5,0.5,true,false,200,850,797,897,597,47,3,true,-1.0
2,0,0.5,0.5,true,false,250,200,245,195,-5,-5,5,true,-1.0
2,0,0.5,0.5,true,false,900,850,897,847,-3,-3,3,true,-1.0
2,0,0.5,0.5,true,false,300,300,348,798,48,498,2,true,-1.0
2,0,0.5,0.5,true,false,850,350,850,350,0,0,0,true,-1.0
2,0,0.5,0.5,true,false,300,900,295,895,-5,-5,5,true,-1.0
2,0,0.5,0.5,true,false,300,850,297,847,-3,-3,3,true,-1.0
2,0,0.5,0.5,true,false,900,250,898,248,-2,-2,2,true,-1.0
2,0,0.5,0.5,false,false,200,350,846,896,646,546,4,true,85.392
2,0,0.5,0.5,false,false,250,350,795,395,545,45,5,true,-1.0
2,0,0.5,0.5,false,false,300,200,397,297,97,97,3,true,-1.0
2,0,0.5,0.5,false,false,300,200,798,298,498,98,2,true,-1.0
2,0,0.5,0.5,false,false,300,200,848,298,548,98,2,true,-1.0
2,0,0.5,0.5,false,false,850,900,847,897,-3,-3,3,true,-1.0
2,0,0.5,0.5,false,false,250,300,247,297,-3,-3,3,true,-1.0
2,0,0.5,0.5,false,false,200,250,195,245,-5,-5,5,false,-1.0
2,0,0.5,0.5,false,false,300,200,300,200,0,0,0,true,-1.0
2,0,0.5,0.5,false,false,300,250,297,247,-3,-3,3,true,-1.0
2,1,0.5,0.5,true,false,250,350,200,300,-50,-50,50,false,1058.077
2,1,0.5,0.5,true,false,300,250,297,247,-3,-3,3,true,-1.0
2,1,0.5,0.5,true,false,250,250,247,247,-3,-3,3,true,-1.0
2,1,0.5,0.5,true,false,200,200,299,249,99,49,1,true,-1.0
2,1,0.5,0.5,true,false,900,850,900,850,0,0,0,true,-1.0
2,1,0.5,0.5,true,false,300,300,250,250,-50,-50,50,false,-1.0
2,1,0.5,0.5,true,false,300,250,847,847,547,597,3,true,-1.0
2,1,0.5,0.5,true,false,850,350,850,350,0,0,0,true,-1.0
2,1,0.5,0.5,true,false,250,300,898,798,648,498,2,true,-1.0
2,1,0.5,0.5,true,false,250,250,298,298,48,48,2,true,-1.0
2,1,0.5,0.5,false,false,850,250,847,247,-3,-3,3,true,107.435
2,1,0.5,0.5,false,false,350,900,350,900,0,0,0,true,-1.0
2,1,0.5,0.5,false,false,900,850,900,850,0,0,0,true,-1.0
2,1,0.5,0.5,false,false,200,350,200,350,0,0,0,true,-1.0
2,1,0.5,0.5,false,false,300,300,297,297,-3,-3,3,true,-1.0
2,1,0.5,0.5,false,false,300,900,289,889,-11,-11,11,true,-1.0
2,1,0.5,0.5,false,false,200,300,398,798,198,498,2,true,-1.0
2,1,0.5,0.5,false,false,250,300,299,899,49,599,1,true,-1.0
2,1,0.5,0.5,false,false,200,300,248,798,48,498,2,true,-1.0
2,1,0.5,0.5,false,false,300,250,300,250,0,0,0,true,-1.0
2,2,0.5,0.5,true,true,900,350,900,350,0,0,0,true,548.35
2,2,0.5,0.5,true,true,300,850,300,850,0,0,0,true,-1.0
2,2,0.5,0.5,true,true,850,850,849,849,-1,-1,1,true,-1.0
2,2,0.5,0.5,true,true,250,250,297,297,47,47,3,true,-1.0
2,2,0.5,0.5,true,true,350,300,349,299,-1,-1,1,true,-1.0
2,2,0.5,0.5,true,true,300,850,298,848,-2,-2,2,true,-1.0
2,2,0.5,0.5,true,true,250,350,246,346,-4,-4,4,true,-1.0
2,2,0.5,0.5,true,true,300,850,299,849,-1,-1,1,true,-1.0
2,2,0.5,0.5,true,true,300,250,849,349,549,99,1,true,-1.0
2,2,0.5,0.5,true,true,200,300,199,299,-1,-1,1,true,-1.0
2,2,0.5,0.5,true,false,300,350,798,948,498,598,2,true,466.463
2,2,0.5,0.5,true,false,300,300,799,899,499,599,1,true,-1.0
2,2,0.5,0.5,true,false,350,300,348,298,-2,-2,2,true,-1.0
2,2,0.5,0.5,true,false,200,200,199,199,-1,-1,1,true,-1.0
2,2,0.5,0.5,true,false,250,300,799,899,549,599,1,true,-1.0
2,2,0.5,0.5,true,false,200,350,197,347,-3,-3,3,true,-1.0
2,2,0.5,0.5,true,false,250,200,846,296,596,96,4,true,-1.0
2,2,0.5,0.5,true,false,250,350,797,947,547,597,3,true,-1.0
2,2,0.5,0.5,true,false,250,850,250,850,0,0,0,true,-1.0
2,2,0.5,0.5,true,false,250,250,247,247,-3,-3,3,true,-1.0
2,2,0.5,0.5,false,true,250,350,298,898,48,548,2,true,140.256
2,2,0.5,0.5,false,true,300,250,349,799,49,549,1,true,-1.0
2,2,0.5,0.5,false,true,200,300,198,298,-2,-2,2,true,-1.0
2,2,0.5,0.5,false,true,200,250,249,299,49,49,1,true,-1.0
2,2,0.5,0.5,false,true,250,850,249,849,-1,-1,1,true,-1.0
2,2,0.5,0.5,false,true,200,200,199,199,-1,-1,1,true,-1.0
2,2,0.5,0.5,false,true,900,300,900,300,0,0,0,true,-1.0
2,2,0.5,0.5,false,true,350,300,349,299,-1,-1,1,true,-1.0
2,2,0.5,0.5,false,true,300,350,296,346,-4,-4,4,true,-1.0
2,2,0.5,0.5,false,true,300,350,797,397,497,47,3,true,-1.0
2,2,0.5,0.5,false,false,250,300,296,796,46,496,4,true,81.012
2,2,0.5,0.5,false,false,200,200,249,299,49,99,1,true,-1.0
2,2,0.5,0.5,false,false,250,250,949,799,699,549,1,true,-1.0
2,2,0.5,0.5,false,false,300,850,299,849,-1,-1,1,true,-1.0
2,2,0.5,0.5,false,false,850,200,849,199,-1,-1,1,true,-1.0
2,2,0.5,0.5,false,false,300,200,298,198,-2,-2,2,true,-1.0
2,2,0.5,0.5,false,false,250,300,799,349,549,49,1,true,-1.0
2,2,0.5,0.5,false,false,250,300,797,897,547,597,3,true,-1.0
2,2,0.5,0.5,false,false,350,350,349,349,-1,-1,1,true,-1.0
2,2,0.5,0.5,false,false,300,300,797,897,497,597,3,true,-1.0
